table_code,var_id,ons_name,E,W,T
TS001,1001,Residence type: Total; measures: Value,56490284,3107463,59597747
TS001,1002,Residence type: Lives in a household; measures: Value,55504403,3051530,58555933
TS001,1003,Residence type: Lives in a communal establishment; measures: Value,985881,55933,1041814
TS002,2001,Marital and civil partnership status: Total; measures: Value,46007142,2559415,48566557
TS002,2002,Marital and civil partnership status: Never married and never registered a civil partnership; measures: Value,17450024,951661,18401685
TS002,2003,Marital and civil partnership status: Married or in a registered civil partnership; measures: Value,20561740,1121478,21683218
TS002,2004,Marital and civil partnership status: Married or in a registered civil partnership: Married; measures: Value,20464357,1116451,21580808
TS002,2005,Marital and civil partnership status: Married or in a registered civil partnership: Married: Opposite sex; measures: Value,20336795,1109680,21446475
TS002,2006,Marital and civil partnership status: Married or in a registered civil partnership: Married: Same sex; measures: Value,127562,6771,134333
TS002,2007,Marital and civil partnership status: Married or in a registered civil partnership: In a registered civil partnership; measures: Value,97383,5027,102410
TS002,2008,Marital and civil partnership status: Married or in a registered civil partnership: In a registered civil partnership: Opposite sex; measures: Value,33976,1706,35682
TS002,2009,Marital and civil partnership status: Married or in a registered civil partnership: In a registered civil partnership: Same sex; measures: Value,63407,3321,66728
TS002,2010,"Marital and civil partnership status: Separated, but still legally married or still legally in a civil partnership; measures: Value",1033213,52531,1085744
TS002,2011,"Marital and civil partnership status: Separated, but still legally married or still legally in a civil partnership: Separated, but still married; measures: Value",1025688,52141,1077829
TS002,2012,"Marital and civil partnership status: Separated, but still legally married or still legally in a civil partnership: Separated, but still in a registered civil partnership; measures: Value",7525,390,7915
TS002,2013,Marital and civil partnership status: Divorced or civil partnership dissolved; measures: Value,4171941,252682,4424623
TS002,2014,Marital and civil partnership status: Divorced or civil partnership dissolved: Divorced; measures: Value,4160598,252127,4412725
TS002,2015,Marital and civil partnership status: Divorced or civil partnership dissolved: Formerly in a civil partnership now legally dissolved; measures: Value,11343,555,11898
TS002,2016,Marital and civil partnership status: Widowed or surviving civil partnership partner; measures: Value,2790224,181063,2971287
TS002,2017,Marital and civil partnership status: Widowed or surviving civil partnership partner: Widowed; measures: Value,2786238,180865,2967103
TS002,2018,Marital and civil partnership status: Widowed or surviving civil partnership partner: Surviving partner from civil partnership; measures: Value,3986,198,4184
TS003,3001,Household composition: Total; measures: Value,23436914,1347235,24784149
TS003,3002,Household composition: One person household; measures: Value,7051779,429615,7481394
TS003,3003,Household composition: One person household: Aged 66 years and over; measures: Value,3001826,196106,3197932
TS003,3004,Household composition: One person household: Other; measures: Value,4049953,233509,4283462
TS003,3005,Household composition: Single family household; measures: Value,14763883,850166,15614049
TS003,3006,Household composition: Single family household: All aged 66 years and over; measures: Value,2145187,138101,2283288
TS003,3007,Household composition: Single family household: Married or civil partnership couple; measures: Value,7130131,386661,7516792
TS003,3008,Household composition: Single family household: Married or civil partnership couple: No children; measures: Value,2440195,145026,2585221
TS003,3009,Household composition: Single family household: Married or civil partnership couple: Dependent children; measures: Value,3375508,159943,3535451
TS003,3010,Household composition: Single family household: Married or civil partnership couple: All children non-dependent; measures: Value,1314428,81692,1396120
TS003,3011,Household composition: Single family household: Cohabiting couple family; measures: Value,2708959,155616,2864575
TS003,3012,Household composition: Single family household: Cohabiting couple family: No children; measures: Value,1487078,77073,1564151
TS003,3013,Household composition: Single family household: Cohabiting couple family: With dependent children; measures: Value,1052747,67902,1120649
TS003,3014,Household composition: Single family household: Cohabiting couple family: All children non-dependent; measures: Value,169134,10641,179775
TS003,3015,Household composition: Single family household: Lone parent family; measures: Value,2595568,161865,2757433
TS003,3016,Household composition: Single family household: Lone parent family: With dependent children; measures: Value,1617468,102300,1719768
TS003,3017,Household composition: Single family household: Lone parent family: All children non-dependent; measures: Value,978100,59565,1037665
TS003,3018,Household composition: Single family household: Other single family household; measures: Value,184038,7923,191961
TS003,3019,Household composition: Single family household: Other single family household: Other family composition; measures: Value,184038,7923,191961
TS003,3020,Household composition: Other household types; measures: Value,1621252,67454,1688706
TS003,3021,Household composition: Other household types: With dependent children; measures: Value,630400,26122,656522
TS003,3022,"Household composition: Other household types: Other, including all full-time students and all aged 66 years and over; measures: Value",990852,41332,1032184
TS004,4001,Country of birth: Total; measures: Value,56490038,3107427,59597465
TS004,4002,Country of birth: Europe; measures: Value,50730742,2992197,53722939
TS004,4003,Country of birth: Europe: United Kingdom; measures: Value,46687576,2892027,49579603
TS004,4004,Country of birth: Europe: EU countries; measures: Value,3551987,91507,3643494
TS004,4005,Country of birth: Europe: EU countries: European Union EU14; measures: Value,1578466,41600,1620066
TS004,4006,Country of birth: Europe: EU countries: European Union EU8; measures: Value,1190611,35254,1225865
TS004,4007,Country of birth: Europe: EU countries: European Union EU2; measures: Value,677124,11894,689018
TS004,4008,Country of birth: Europe: EU countries: All other EU countries; measures: Value,105786,2759,108545
TS004,4009,Country of birth: Europe: Non-EU countries; measures: Value,491179,8663,499842
TS004,4010,Country of birth: Europe: Non-EU countries: All other non-EU countries; measures: Value,491179,8663,499842
TS004,4011,Country of birth: Africa; measures: Value,1555767,28695,1584462
TS004,4012,Country of birth: Middle East and Asia; measures: Value,3241474,69342,3310816
TS004,4013,Country of birth: The Americas and the Caribbean; measures: Value,773437,12346,785783
TS004,4014,Country of birth: Antarctica and Oceania (including Australasia) and Other; measures: Value,167820,4535,172355
TS004,4015,Country of birth: British Overseas ; measures: Value,20798,312,21110
TS005,5001,Passports held: Total; measures: Value,56491289,3107469,59598758
TS005,5002,Passports held: Europe; measures: Value,47260487,2485703,49746190
TS005,5003,Passports held: Europe: United Kingdom; measures: Value,43288554,2399711,45688265
TS005,5004,Passports held: Europe: Ireland; measures: Value,355196,9810,365006
TS005,5005,Passports held: Europe: Other Europe; measures: Value,3616737,76182,3692919
TS005,5006,Passports held: Europe: Other Europe: EU Member countries; measures: Value,3447700,73219,3520919
TS005,5007,Passports held: Europe: Other Europe: EU Member countries: France; measures: Value,161493,2134,163627
TS005,5008,Passports held: Europe: Other Europe: EU Member countries: Germany; measures: Value,116429,2833,119262
TS005,5009,Passports held: Europe: Other Europe: EU Member countries: Italy; measures: Value,363927,4815,368742
TS005,5010,Passports held: Europe: Other Europe: EU Member countries: Portugal; measures: Value,282088,4668,286756
TS005,5011,Passports held: Europe: Other Europe: EU Member countries: Spain; measures: Value,213824,2846,216670
TS005,5012,Passports held: Europe: Other Europe: EU Member countries: Lithuania; measures: Value,182329,2845,185174
TS005,5013,Passports held: Europe: Other Europe: EU Member countries: Poland; measures: Value,734387,25749,760136
TS005,5014,Passports held: Europe: Other Europe: EU Member countries: Romania; measures: Value,542602,7850,550452
TS005,5015,Passports held: Europe: Other Europe: EU Member countries: Other EU countries; measures: Value,850621,19479,870100
TS005,5016,Passports held: Europe: Other Europe: Rest of Europe; measures: Value,169037,2963,172000
TS005,5017,Passports held: Europe: Other Europe: Rest of Europe: Turkey; measures: Value,44238,1205,45443
TS005,5018,Passports held: Europe: Other Europe: Rest of Europe: Other Europe; measures: Value,124799,1758,126557
TS005,5019,Passports held: Africa; measures: Value,370674,8136,378810
TS005,5020,Passports held: Africa: North Africa; measures: Value,52574,2055,54629
TS005,5021,Passports held: Africa: Central and Western Africa; measures: Value,192006,3267,195273
TS005,5022,Passports held: Africa: South and Eastern Africa; measures: Value,126094,2814,128908
TS005,5023,Passports held: Middle East and Asia; measures: Value,1052410,23933,1076343
TS005,5024,Passports held: Middle East and Asia: Middle East; measures: Value,68794,3311,72105
TS005,5025,Passports held: Middle East and Asia: Eastern Asia; measures: Value,169844,5004,174848
TS005,5026,Passports held: Middle East and Asia: Southern Asia; measures: Value,681800,11720,693520
TS005,5027,Passports held: Middle East and Asia: South-East Asia; measures: Value,127187,3803,130990
TS005,5028,Passports held: Middle East and Asia: Central Asia; measures: Value,4785,95,4880
TS005,5029,Passports held: The Americas and the Caribbean; measures: Value,295156,4997,300153
TS005,5030,Passports held: The Americas and the Caribbean: North America and the Caribbean; measures: Value,199206,3775,202981
TS005,5031,Passports held: The Americas and the Caribbean: Central and South America; measures: Value,95950,1222,97172
TS005,5032,"Passports held: Antarctica and Oceania, including Australasia; measures: Value",75397,1494,76891
TS005,5033,Passports held: British Overseas Territories; measures: Value,627,12,639
TS005,5034,Passports held: No passport held; measures: Value,7436538,583194,8019732
TS006,6001,Population Density: Persons per square kilometre; measures: Value,1082697785.9,35976644.7,1118674430.6
TS007,7001,Age: Total; measures: Value,56489439,3107408,59596847
TS007,7002,Age: Aged 4 years and under; measures: Value,3076902,155088,3231990
TS007,7003,Age: Aged under 1 year; measures: Value,578985,28345,607330
TS007,7004,Age: Aged 1 year; measures: Value,605877,29816,635693
TS007,7005,Age: Aged 2 years; measures: Value,619044,31158,650202
TS007,7006,Age: Aged 3 years; measures: Value,626367,32401,658768
TS007,7007,Age: Aged 4 years; measures: Value,646629,33368,679997
TS007,7008,Age: Aged 5 to 9 years; measures: Value,3348482,175920,3524402
TS007,7009,Age: Aged 5 years; measures: Value,658636,34452,693088
TS007,7010,Age: Aged 6 years; measures: Value,650579,34082,684661
TS007,7011,Age: Aged 7 years; measures: Value,658767,34371,693138
TS007,7012,Age: Aged 8 years; measures: Value,686118,36188,722306
TS007,7013,Age: Aged 9 years; measures: Value,694382,36827,731209
TS007,7014,Age: Aged 10 to 15 years; measures: Value,4057255,217077,4274332
TS007,7015,Age: Aged 10 years; measures: Value,694511,37050,731561
TS007,7016,Age: Aged 11 years; measures: Value,687693,36790,724483
TS007,7017,Age: Aged 12 years; measures: Value,685151,36772,721923
TS007,7018,Age: Aged 13 years; measures: Value,682578,36765,719343
TS007,7019,Age: Aged 14 years; measures: Value,663183,35335,698518
TS007,7020,Age: Aged 15 years; measures: Value,644139,34365,678504
TS007,7021,Age: Aged 16 to 19 years; measures: Value,2574802,141418,2716220
TS007,7022,Age: Aged 16 years; measures: Value,649414,35247,684661
TS007,7023,Age: Aged 17 years; measures: Value,642082,34286,676368
TS007,7024,Age: Aged 18 years; measures: Value,633096,34596,667692
TS007,7025,Age: Aged 19 years; measures: Value,650210,37289,687499
TS007,7026,Age: Aged 20 to 24 years; measures: Value,3414505,187637,3602142
TS007,7027,Age: Aged 20 years; measures: Value,649255,36906,686161
TS007,7028,Age: Aged 21 years; measures: Value,668365,37809,706174
TS007,7029,Age: Aged 22 years; measures: Value,687527,37842,725369
TS007,7030,Age: Aged 23 years; measures: Value,698316,37399,735715
TS007,7031,Age: Aged 24 years; measures: Value,711042,37681,748723
TS007,7032,Age: Aged 25 to 34 years; measures: Value,7667647,382652,8050299
TS007,7033,Age: Aged 25 years; measures: Value,712015,36052,748067
TS007,7034,Age: Aged 26 years; measures: Value,727399,36687,764086
TS007,7035,Age: Aged 27 years; measures: Value,742786,37235,780021
TS007,7036,Age: Aged 28 years; measures: Value,756274,37654,793928
TS007,7037,Age: Aged 29 years; measures: Value,776726,38827,815553
TS007,7038,Age: Aged 30 years; measures: Value,797889,40036,837925
TS007,7039,Age: Aged 31 years; measures: Value,788776,38654,827430
TS007,7040,Age: Aged 32 years; measures: Value,790595,39222,829817
TS007,7041,Age: Aged 33 years; measures: Value,799044,39345,838389
TS007,7042,Age: Aged 34 years; measures: Value,776143,38940,815083
TS007,7043,Age: Aged 35 to 49 years; measures: Value,10978736,547674,11526410
TS007,7044,Age: Aged 35 years; measures: Value,776411,37944,814355
TS007,7045,Age: Aged 36 years; measures: Value,767282,37852,805134
TS007,7046,Age: Aged 37 years; measures: Value,753540,36851,790391
TS007,7047,Age: Aged 38 years; measures: Value,748951,36846,785797
TS007,7048,Age: Aged 39 years; measures: Value,749240,36725,785965
TS007,7049,Age: Aged 40 years; measures: Value,766276,37771,804047
TS007,7050,Age: Aged 41 years; measures: Value,754189,37163,791352
TS007,7051,Age: Aged 42 years; measures: Value,714346,34616,748962
TS007,7052,Age: Aged 43 years; measures: Value,672626,32692,705318
TS007,7053,Age: Aged 44 years; measures: Value,673086,33126,706212
TS007,7054,Age: Aged 45 years; measures: Value,682829,33717,716546
TS007,7055,Age: Aged 46 years; measures: Value,699663,35277,734940
TS007,7056,Age: Aged 47 years; measures: Value,710575,36319,746894
TS007,7057,Age: Aged 48 years; measures: Value,740125,38992,779117
TS007,7058,Age: Aged 49 years; measures: Value,769597,41783,811380
TS007,7059,Age: Aged 50 to 64 years; measures: Value,10969861,637897,11607758
TS007,7060,Age: Aged 50 years; measures: Value,785284,42777,828061
TS007,7061,Age: Aged 51 years; measures: Value,768697,42249,810946
TS007,7062,Age: Aged 52 years; measures: Value,786240,43578,829818
TS007,7063,Age: Aged 53 years; measures: Value,781349,42983,824332
TS007,7064,Age: Aged 54 years; measures: Value,786014,44060,830074
TS007,7065,Age: Aged 55 years; measures: Value,784069,44648,828717
TS007,7066,Age: Aged 56 years; measures: Value,783931,45658,829589
TS007,7067,Age: Aged 57 years; measures: Value,765142,45152,810294
TS007,7068,Age: Aged 58 years; measures: Value,748611,44239,792850
TS007,7069,Age: Aged 59 years; measures: Value,724498,42954,767452
TS007,7070,Age: Aged 60 years; measures: Value,701440,42011,743451
TS007,7071,Age: Aged 61 years; measures: Value,666392,40560,706952
TS007,7072,Age: Aged 62 years; measures: Value,652485,39941,692426
TS007,7073,Age: Aged 63 years; measures: Value,632289,39332,671621
TS007,7074,Age: Aged 64 years; measures: Value,603420,37755,641175
TS007,7075,Age: Aged 65 to 74 years; measures: Value,5564182,359002,5923184
TS007,7076,Age: Aged 65 years; measures: Value,576022,35675,611697
TS007,7077,Age: Aged 66 years; measures: Value,560578,35697,596275
TS007,7078,Age: Aged 67 years; measures: Value,559991,36449,596440
TS007,7079,Age: Aged 68 years; measures: Value,540691,35405,576096
TS007,7080,Age: Aged 69 years; measures: Value,530161,34419,564580
TS007,7081,Age: Aged 70 years; measures: Value,529651,34843,564494
TS007,7082,Age: Aged 71 years; measures: Value,539490,35386,574876
TS007,7083,Age: Aged 72 years; measures: Value,547989,35808,583797
TS007,7084,Age: Aged 73 years; measures: Value,593130,38244,631374
TS007,7085,Age: Aged 74 years; measures: Value,586479,37076,623555
TS007,7086,Age: Aged 75 to 84 years; measures: Value,3464978,220518,3685496
TS007,7087,Age: Aged 75 years; measures: Value,441365,28178,469543
TS007,7088,Age: Aged 76 years; measures: Value,461235,29496,490731
TS007,7089,Age: Aged 77 years; measures: Value,420120,26718,446838
TS007,7090,Age: Aged 78 years; measures: Value,387818,25343,413161
TS007,7091,Age: Aged 79 years; measures: Value,328292,21774,350066
TS007,7092,Age: Aged 80 years; measures: Value,306415,20169,326584
TS007,7093,Age: Aged 81 years; measures: Value,309629,19091,328720
TS007,7094,Age: Aged 82 years; measures: Value,292647,17933,310580
TS007,7095,Age: Aged 83 years; measures: Value,270457,16591,287048
TS007,7096,Age: Aged 84 years; measures: Value,247000,15225,262225
TS007,7097,Age: Aged 85 years and over; measures: Value,1372089,82525,1454614
TS007,7098,Age: Aged 85 years; measures: Value,220604,13415,234019
TS007,7099,Age: Aged 86 years; measures: Value,196138,12024,208162
TS007,7100,Age: Aged 87 years; measures: Value,170837,10263,181100
TS007,7101,Age: Aged 88 years; measures: Value,152164,9245,161409
TS007,7102,Age: Aged 89 years; measures: Value,132693,7874,140567
TS007,7103,Age: Aged 90 years; measures: Value,115353,6773,122126
TS007,7104,Age: Aged 91 years; measures: Value,93408,5535,98943
TS007,7105,Age: Aged 92 years; measures: Value,74949,4423,79372
TS007,7106,Age: Aged 93 years; measures: Value,58147,3451,61598
TS007,7107,Age: Aged 94 years; measures: Value,45697,2712,48409
TS007,7108,Age: Aged 95 years; measures: Value,34087,2097,36184
TS007,7109,Age: Aged 96 years; measures: Value,25195,1554,26749
TS007,7110,Age: Aged 97 years; measures: Value,17918,1075,18993
TS007,7111,Age: Aged 98 years; measures: Value,12758,737,13495
TS007,7112,Age: Aged 99 years; measures: Value,9067,538,9605
TS007,7113,Age: Aged 100 years and over; measures: Value,13074,809,13883
TS008,8001,Sex: All persons; measures: Value,56489752,3107574,59597326
TS008,8002,Sex: Female; measures: Value,28833503,1586521,30420024
TS008,8003,Sex: Male; measures: Value,27656249,1521053,29177302
TS009,9001,Sex: All persons; Age: Total; measures: Value,56490040,3107489,59597529
TS009,9002,Sex: All persons; Age: Aged 4 years and under; measures: Value,3076951,155081,3232032
TS009,9003,Sex: All persons; Age: Aged under 1 year; measures: Value,578988,28335,607323
TS009,9004,Sex: All persons; Age: Aged 1 year; measures: Value,605940,29825,635765
TS009,9005,Sex: All persons; Age: Aged 2 years; measures: Value,619027,31157,650184
TS009,9006,Sex: All persons; Age: Aged 3 years; measures: Value,626363,32407,658770
TS009,9007,Sex: All persons; Age: Aged 4 years; measures: Value,646633,33357,679990
TS009,9008,Sex: All persons; Age: Aged 5 to 9 years; measures: Value,3348709,175937,3524646
TS009,9009,Sex: All persons; Age: Aged 5 years; measures: Value,658689,34454,693143
TS009,9010,Sex: All persons; Age: Aged 6 years; measures: Value,650551,34084,684635
TS009,9011,Sex: All persons; Age: Aged 7 years; measures: Value,658881,34380,693261
TS009,9012,Sex: All persons; Age: Aged 8 years; measures: Value,686132,36203,722335
TS009,9013,Sex: All persons; Age: Aged 9 years; measures: Value,694456,36816,731272
TS009,9014,Sex: All persons; Age: Aged 10 to 15 years; measures: Value,4057466,217084,4274550
TS009,9015,Sex: All persons; Age: Aged 10 years; measures: Value,694521,37050,731571
TS009,9016,Sex: All persons; Age: Aged 11 years; measures: Value,687734,36776,724510
TS009,9017,Sex: All persons; Age: Aged 12 years; measures: Value,685268,36787,722055
TS009,9018,Sex: All persons; Age: Aged 13 years; measures: Value,682624,36780,719404
TS009,9019,Sex: All persons; Age: Aged 14 years; measures: Value,663202,35324,698526
TS009,9020,Sex: All persons; Age: Aged 15 years; measures: Value,644117,34367,678484
TS009,9021,Sex: All persons; Age: Aged 16 to 19 years; measures: Value,2574785,141407,2716192
TS009,9022,Sex: All persons; Age: Aged 16 years; measures: Value,649474,35247,684721
TS009,9023,Sex: All persons; Age: Aged 17 years; measures: Value,642051,34285,676336
TS009,9024,Sex: All persons; Age: Aged 18 years; measures: Value,633054,34585,667639
TS009,9025,Sex: All persons; Age: Aged 19 years; measures: Value,650206,37290,687496
TS009,9026,Sex: All persons; Age: Aged 20 to 24 years; measures: Value,3414481,187683,3602164
TS009,9027,Sex: All persons; Age: Aged 20 years; measures: Value,649306,36918,686224
TS009,9028,Sex: All persons; Age: Aged 21 years; measures: Value,668342,37798,706140
TS009,9029,Sex: All persons; Age: Aged 22 years; measures: Value,687518,37858,725376
TS009,9030,Sex: All persons; Age: Aged 23 years; measures: Value,698307,37414,735721
TS009,9031,Sex: All persons; Age: Aged 24 years; measures: Value,711008,37695,748703
TS009,9032,Sex: All persons; Age: Aged 25 to 34 years; measures: Value,7667861,382662,8050523
TS009,9033,Sex: All persons; Age: Aged 25 years; measures: Value,711902,36034,747936
TS009,9034,Sex: All persons; Age: Aged 26 years; measures: Value,727395,36673,764068
TS009,9035,Sex: All persons; Age: Aged 27 years; measures: Value,742903,37240,780143
TS009,9036,Sex: All persons; Age: Aged 28 years; measures: Value,756335,37671,794006
TS009,9037,Sex: All persons; Age: Aged 29 years; measures: Value,776754,38835,815589
TS009,9038,Sex: All persons; Age: Aged 30 years; measures: Value,797944,40031,837975
TS009,9039,Sex: All persons; Age: Aged 31 years; measures: Value,788762,38651,827413
TS009,9040,Sex: All persons; Age: Aged 32 years; measures: Value,790636,39242,829878
TS009,9041,Sex: All persons; Age: Aged 33 years; measures: Value,799058,39337,838395
TS009,9042,Sex: All persons; Age: Aged 34 years; measures: Value,776172,38948,815120
TS009,9043,Sex: All persons; Age: Aged 35 to 49 years; measures: Value,10978381,547663,11526044
TS009,9044,Sex: All persons; Age: Aged 35 years; measures: Value,776435,37936,814371
TS009,9045,Sex: All persons; Age: Aged 36 years; measures: Value,767266,37854,805120
TS009,9046,Sex: All persons; Age: Aged 37 years; measures: Value,753534,36839,790373
TS009,9047,Sex: All persons; Age: Aged 38 years; measures: Value,748860,36860,785720
TS009,9048,Sex: All persons; Age: Aged 39 years; measures: Value,749264,36739,786003
TS009,9049,Sex: All persons; Age: Aged 40 years; measures: Value,766202,37769,803971
TS009,9050,Sex: All persons; Age: Aged 41 years; measures: Value,754179,37161,791340
TS009,9051,Sex: All persons; Age: Aged 42 years; measures: Value,714361,34614,748975
TS009,9052,Sex: All persons; Age: Aged 43 years; measures: Value,672566,32689,705255
TS009,9053,Sex: All persons; Age: Aged 44 years; measures: Value,673075,33128,706203
TS009,9054,Sex: All persons; Age: Aged 45 years; measures: Value,682825,33714,716539
TS009,9055,Sex: All persons; Age: Aged 46 years; measures: Value,699710,35269,734979
TS009,9056,Sex: All persons; Age: Aged 47 years; measures: Value,710490,36326,746816
TS009,9057,Sex: All persons; Age: Aged 48 years; measures: Value,740027,38995,779022
TS009,9058,Sex: All persons; Age: Aged 49 years; measures: Value,769587,41770,811357
TS009,9059,Sex: All persons; Age: Aged 50 to 64 years; measures: Value,10970120,637944,11608064
TS009,9060,Sex: All persons; Age: Aged 50 years; measures: Value,785277,42784,828061
TS009,9061,Sex: All persons; Age: Aged 51 years; measures: Value,768745,42254,810999
TS009,9062,Sex: All persons; Age: Aged 52 years; measures: Value,786297,43588,829885
TS009,9063,Sex: All persons; Age: Aged 53 years; measures: Value,781411,42982,824393
TS009,9064,Sex: All persons; Age: Aged 54 years; measures: Value,786028,44069,830097
TS009,9065,Sex: All persons; Age: Aged 55 years; measures: Value,784110,44650,828760
TS009,9066,Sex: All persons; Age: Aged 56 years; measures: Value,783959,45645,829604
TS009,9067,Sex: All persons; Age: Aged 57 years; measures: Value,765133,45161,810294
TS009,9068,Sex: All persons; Age: Aged 58 years; measures: Value,748631,44244,792875
TS009,9069,Sex: All persons; Age: Aged 59 years; measures: Value,724524,42961,767485
TS009,9070,Sex: All persons; Age: Aged 60 years; measures: Value,701388,42009,743397
TS009,9071,Sex: All persons; Age: Aged 61 years; measures: Value,666431,40572,707003
TS009,9072,Sex: All persons; Age: Aged 62 years; measures: Value,652420,39941,692361
TS009,9073,Sex: All persons; Age: Aged 63 years; measures: Value,632332,39333,671665
TS009,9074,Sex: All persons; Age: Aged 64 years; measures: Value,603434,37751,641185
TS009,9075,Sex: All persons; Age: Aged 65 to 74 years; measures: Value,5564109,358963,5923072
TS009,9076,Sex: All persons; Age: Aged 65 years; measures: Value,576025,35681,611706
TS009,9077,Sex: All persons; Age: Aged 66 years; measures: Value,560610,35676,596286
TS009,9078,Sex: All persons; Age: Aged 67 years; measures: Value,559971,36436,596407
TS009,9079,Sex: All persons; Age: Aged 68 years; measures: Value,540675,35413,576088
TS009,9080,Sex: All persons; Age: Aged 69 years; measures: Value,530202,34425,564627
TS009,9081,Sex: All persons; Age: Aged 70 years; measures: Value,529677,34829,564506
TS009,9082,Sex: All persons; Age: Aged 71 years; measures: Value,539443,35366,574809
TS009,9083,Sex: All persons; Age: Aged 72 years; measures: Value,547915,35809,583724
TS009,9084,Sex: All persons; Age: Aged 73 years; measures: Value,593126,38258,631384
TS009,9085,Sex: All persons; Age: Aged 74 years; measures: Value,586465,37070,623535
TS009,9086,Sex: All persons; Age: Aged 75 to 84 years; measures: Value,3464879,220496,3685375
TS009,9087,Sex: All persons; Age: Aged 75 years; measures: Value,441359,28189,469548
TS009,9088,Sex: All persons; Age: Aged 76 years; measures: Value,461259,29492,490751
TS009,9089,Sex: All persons; Age: Aged 77 years; measures: Value,420024,26708,446732
TS009,9090,Sex: All persons; Age: Aged 78 years; measures: Value,387809,25350,413159
TS009,9091,Sex: All persons; Age: Aged 79 years; measures: Value,328288,21766,350054
TS009,9092,Sex: All persons; Age: Aged 80 years; measures: Value,306499,20161,326660
TS009,9093,Sex: All persons; Age: Aged 81 years; measures: Value,309593,19076,328669
TS009,9094,Sex: All persons; Age: Aged 82 years; measures: Value,292602,17937,310539
TS009,9095,Sex: All persons; Age: Aged 83 years; measures: Value,270465,16588,287053
TS009,9096,Sex: All persons; Age: Aged 84 years; measures: Value,246981,15229,262210
TS009,9097,Sex: All persons; Age: Aged 85 years and over; measures: Value,1372298,82569,1454867
TS009,9098,Sex: All persons; Age: Aged 85 years; measures: Value,220583,13443,234026
TS009,9099,Sex: All persons; Age: Aged 86 years; measures: Value,196079,12036,208115
TS009,9100,Sex: All persons; Age: Aged 87 years; measures: Value,170826,10264,181090
TS009,9101,Sex: All persons; Age: Aged 88 years; measures: Value,152228,9235,161463
TS009,9102,Sex: All persons; Age: Aged 89 years; measures: Value,132793,7877,140670
TS009,9103,Sex: All persons; Age: Aged 90 years and over; measures: Value,499789,29714,529503
TS009,9104,Sex: Female; Age: Total; measures: Value,28833831,1586489,30420320
TS009,9105,Sex: Female; Age: Aged 4 years and under; measures: Value,1501644,75696,1577340
TS009,9106,Sex: Female; Age: Aged under 1 year; measures: Value,282931,13757,296688
TS009,9107,Sex: Female; Age: Aged 1 year; measures: Value,295635,14718,310353
TS009,9108,Sex: Female; Age: Aged 2 years; measures: Value,301595,15077,316672
TS009,9109,Sex: Female; Age: Aged 3 years; measures: Value,306045,15834,321879
TS009,9110,Sex: Female; Age: Aged 4 years; measures: Value,315438,16310,331748
TS009,9111,Sex: Female; Age: Aged 5 to 9 years; measures: Value,1634502,85975,1720477
TS009,9112,Sex: Female; Age: Aged 5 years; measures: Value,321121,16899,338020
TS009,9113,Sex: Female; Age: Aged 6 years; measures: Value,317728,16517,334245
TS009,9114,Sex: Female; Age: Aged 7 years; measures: Value,321923,16708,338631
TS009,9115,Sex: Female; Age: Aged 8 years; measures: Value,334278,17777,352055
TS009,9116,Sex: Female; Age: Aged 9 years; measures: Value,339452,18074,357526
TS009,9117,Sex: Female; Age: Aged 10 to 15 years; measures: Value,1977779,105626,2083405
TS009,9118,Sex: Female; Age: Aged 10 years; measures: Value,337931,17922,355853
TS009,9119,Sex: Female; Age: Aged 11 years; measures: Value,335471,18142,353613
TS009,9120,Sex: Female; Age: Aged 12 years; measures: Value,334864,17644,352508
TS009,9121,Sex: Female; Age: Aged 13 years; measures: Value,332217,18171,350388
TS009,9122,Sex: Female; Age: Aged 14 years; measures: Value,323710,17075,340785
TS009,9123,Sex: Female; Age: Aged 15 years; measures: Value,313586,16672,330258
TS009,9124,Sex: Female; Age: Aged 16 to 19 years; measures: Value,1254579,68399,1322978
TS009,9125,Sex: Female; Age: Aged 16 years; measures: Value,315213,16949,332162
TS009,9126,Sex: Female; Age: Aged 17 years; measures: Value,311184,16719,327903
TS009,9127,Sex: Female; Age: Aged 18 years; measures: Value,308266,16564,324830
TS009,9128,Sex: Female; Age: Aged 19 years; measures: Value,319916,18167,338083
TS009,9129,Sex: Female; Age: Aged 20 to 24 years; measures: Value,1701606,91768,1793374
TS009,9130,Sex: Female; Age: Aged 20 years; measures: Value,319940,17735,337675
TS009,9131,Sex: Female; Age: Aged 21 years; measures: Value,330241,18206,348447
TS009,9132,Sex: Female; Age: Aged 22 years; measures: Value,342462,18406,360868
TS009,9133,Sex: Female; Age: Aged 23 years; measures: Value,350326,18731,369057
TS009,9134,Sex: Female; Age: Aged 24 years; measures: Value,358637,18690,377327
TS009,9135,Sex: Female; Age: Aged 25 to 34 years; measures: Value,3941733,195292,4137025
TS009,9136,Sex: Female; Age: Aged 25 years; measures: Value,359802,17832,377634
TS009,9137,Sex: Female; Age: Aged 26 years; measures: Value,370037,18568,388605
TS009,9138,Sex: Female; Age: Aged 27 years; measures: Value,379843,18902,398745
TS009,9139,Sex: Female; Age: Aged 28 years; measures: Value,388234,19145,407379
TS009,9140,Sex: Female; Age: Aged 29 years; measures: Value,399470,20029,419499
TS009,9141,Sex: Female; Age: Aged 30 years; measures: Value,410251,20498,430749
TS009,9142,Sex: Female; Age: Aged 31 years; measures: Value,407045,19741,426786
TS009,9143,Sex: Female; Age: Aged 32 years; measures: Value,409413,20131,429544
TS009,9144,Sex: Female; Age: Aged 33 years; measures: Value,413832,20480,434312
TS009,9145,Sex: Female; Age: Aged 34 years; measures: Value,403806,19966,423772
TS009,9146,Sex: Female; Age: Aged 35 to 49 years; measures: Value,5605752,280600,5886352
TS009,9147,Sex: Female; Age: Aged 35 years; measures: Value,400035,19504,419539
TS009,9148,Sex: Female; Age: Aged 36 years; measures: Value,395936,19460,415396
TS009,9149,Sex: Female; Age: Aged 37 years; measures: Value,388143,18989,407132
TS009,9150,Sex: Female; Age: Aged 38 years; measures: Value,385260,18978,404238
TS009,9151,Sex: Female; Age: Aged 39 years; measures: Value,384096,18977,403073
TS009,9152,Sex: Female; Age: Aged 40 years; measures: Value,393495,19511,413006
TS009,9153,Sex: Female; Age: Aged 41 years; measures: Value,385945,18775,404720
TS009,9154,Sex: Female; Age: Aged 42 years; measures: Value,363848,17682,381530
TS009,9155,Sex: Female; Age: Aged 43 years; measures: Value,341805,16757,358562
TS009,9156,Sex: Female; Age: Aged 44 years; measures: Value,341616,16767,358383
TS009,9157,Sex: Female; Age: Aged 45 years; measures: Value,346231,17183,363414
TS009,9158,Sex: Female; Age: Aged 46 years; measures: Value,354494,17898,372392
TS009,9159,Sex: Female; Age: Aged 47 years; measures: Value,359915,18712,378627
TS009,9160,Sex: Female; Age: Aged 48 years; measures: Value,374716,20067,394783
TS009,9161,Sex: Female; Age: Aged 49 years; measures: Value,390217,21340,411557
TS009,9162,Sex: Female; Age: Aged 50 to 64 years; measures: Value,5575614,327018,5902632
TS009,9163,Sex: Female; Age: Aged 50 years; measures: Value,399763,21979,421742
TS009,9164,Sex: Female; Age: Aged 51 years; measures: Value,390019,21734,411753
TS009,9165,Sex: Female; Age: Aged 52 years; measures: Value,399567,22317,421884
TS009,9166,Sex: Female; Age: Aged 53 years; measures: Value,397203,22218,419421
TS009,9167,Sex: Female; Age: Aged 54 years; measures: Value,398325,22730,421055
TS009,9168,Sex: Female; Age: Aged 55 years; measures: Value,399259,22880,422139
TS009,9169,Sex: Female; Age: Aged 56 years; measures: Value,398746,23281,422027
TS009,9170,Sex: Female; Age: Aged 57 years; measures: Value,389462,23306,412768
TS009,9171,Sex: Female; Age: Aged 58 years; measures: Value,380821,22672,403493
TS009,9172,Sex: Female; Age: Aged 59 years; measures: Value,368415,21919,390334
TS009,9173,Sex: Female; Age: Aged 60 years; measures: Value,354856,21493,376349
TS009,9174,Sex: Female; Age: Aged 61 years; measures: Value,337894,20723,358617
TS009,9175,Sex: Female; Age: Aged 62 years; measures: Value,332097,20217,352314
TS009,9176,Sex: Female; Age: Aged 63 years; measures: Value,321224,20178,341402
TS009,9177,Sex: Female; Age: Aged 64 years; measures: Value,307963,19371,327334
TS009,9178,Sex: Female; Age: Aged 65 to 74 years; measures: Value,2890456,184978,3075434
TS009,9179,Sex: Female; Age: Aged 65 years; measures: Value,294276,18365,312641
TS009,9180,Sex: Female; Age: Aged 66 years; measures: Value,288353,18350,306703
TS009,9181,Sex: Female; Age: Aged 67 years; measures: Value,288288,18766,307054
TS009,9182,Sex: Female; Age: Aged 68 years; measures: Value,279740,18236,297976
TS009,9183,Sex: Female; Age: Aged 69 years; measures: Value,274931,17666,292597
TS009,9184,Sex: Female; Age: Aged 70 years; measures: Value,275550,18030,293580
TS009,9185,Sex: Female; Age: Aged 71 years; measures: Value,282606,17990,300596
TS009,9186,Sex: Female; Age: Aged 72 years; measures: Value,286696,18453,305149
TS009,9187,Sex: Female; Age: Aged 73 years; measures: Value,311504,19727,331231
TS009,9188,Sex: Female; Age: Aged 74 years; measures: Value,308512,19395,327907
TS009,9189,Sex: Female; Age: Aged 75 to 84 years; measures: Value,1890093,119338,2009431
TS009,9190,Sex: Female; Age: Aged 75 years; measures: Value,233624,14808,248432
TS009,9191,Sex: Female; Age: Aged 76 years; measures: Value,245197,15607,260804
TS009,9192,Sex: Female; Age: Aged 77 years; measures: Value,224578,13987,238565
TS009,9193,Sex: Female; Age: Aged 78 years; measures: Value,209038,13632,222670
TS009,9194,Sex: Female; Age: Aged 79 years; measures: Value,179082,11811,190893
TS009,9195,Sex: Female; Age: Aged 80 years; measures: Value,168766,11032,179798
TS009,9196,Sex: Female; Age: Aged 81 years; measures: Value,171872,10399,182271
TS009,9197,Sex: Female; Age: Aged 82 years; measures: Value,163820,9981,173801
TS009,9198,Sex: Female; Age: Aged 83 years; measures: Value,152913,9330,162243
TS009,9199,Sex: Female; Age: Aged 84 years; measures: Value,141203,8751,149954
TS009,9200,Sex: Female; Age: Aged 85 years and over; measures: Value,860073,51799,911872
TS009,9201,Sex: Female; Age: Aged 85 years; measures: Value,128327,7792,136119
TS009,9202,Sex: Female; Age: Aged 86 years; measures: Value,115295,7008,122303
TS009,9203,Sex: Female; Age: Aged 87 years; measures: Value,102186,6161,108347
TS009,9204,Sex: Female; Age: Aged 88 years; measures: Value,92695,5667,98362
TS009,9205,Sex: Female; Age: Aged 89 years; measures: Value,82415,4972,87387
TS009,9206,Sex: Female; Age: Aged 90 years and over; measures: Value,339155,20199,359354
TS009,9207,Sex: Male; Age: Total; measures: Value,27656209,1521000,29177209
TS009,9208,Sex: Male; Age: Aged 4 years and under; measures: Value,1575307,79385,1654692
TS009,9209,Sex: Male; Age: Aged under 1 year; measures: Value,296057,14578,310635
TS009,9210,Sex: Male; Age: Aged 1 year; measures: Value,310305,15107,325412
TS009,9211,Sex: Male; Age: Aged 2 years; measures: Value,317432,16080,333512
TS009,9212,Sex: Male; Age: Aged 3 years; measures: Value,320318,16573,336891
TS009,9213,Sex: Male; Age: Aged 4 years; measures: Value,331195,17047,348242
TS009,9214,Sex: Male; Age: Aged 5 to 9 years; measures: Value,1714207,89962,1804169
TS009,9215,Sex: Male; Age: Aged 5 years; measures: Value,337568,17555,355123
TS009,9216,Sex: Male; Age: Aged 6 years; measures: Value,332823,17567,350390
TS009,9217,Sex: Male; Age: Aged 7 years; measures: Value,336958,17672,354630
TS009,9218,Sex: Male; Age: Aged 8 years; measures: Value,351854,18426,370280
TS009,9219,Sex: Male; Age: Aged 9 years; measures: Value,355004,18742,373746
TS009,9220,Sex: Male; Age: Aged 10 to 15 years; measures: Value,2079687,111458,2191145
TS009,9221,Sex: Male; Age: Aged 10 years; measures: Value,356590,19128,375718
TS009,9222,Sex: Male; Age: Aged 11 years; measures: Value,352263,18634,370897
TS009,9223,Sex: Male; Age: Aged 12 years; measures: Value,350404,19143,369547
TS009,9224,Sex: Male; Age: Aged 13 years; measures: Value,350407,18609,369016
TS009,9225,Sex: Male; Age: Aged 14 years; measures: Value,339492,18249,357741
TS009,9226,Sex: Male; Age: Aged 15 years; measures: Value,330531,17695,348226
TS009,9227,Sex: Male; Age: Aged 16 to 19 years; measures: Value,1320206,73008,1393214
TS009,9228,Sex: Male; Age: Aged 16 years; measures: Value,334261,18298,352559
TS009,9229,Sex: Male; Age: Aged 17 years; measures: Value,330867,17566,348433
TS009,9230,Sex: Male; Age: Aged 18 years; measures: Value,324788,18021,342809
TS009,9231,Sex: Male; Age: Aged 19 years; measures: Value,330290,19123,349413
TS009,9232,Sex: Male; Age: Aged 20 to 24 years; measures: Value,1712875,95915,1808790
TS009,9233,Sex: Male; Age: Aged 20 years; measures: Value,329366,19183,348549
TS009,9234,Sex: Male; Age: Aged 21 years; measures: Value,338101,19592,357693
TS009,9235,Sex: Male; Age: Aged 22 years; measures: Value,345056,19452,364508
TS009,9236,Sex: Male; Age: Aged 23 years; measures: Value,347981,18683,366664
TS009,9237,Sex: Male; Age: Aged 24 years; measures: Value,352371,19005,371376
TS009,9238,Sex: Male; Age: Aged 25 to 34 years; measures: Value,3726128,187370,3913498
TS009,9239,Sex: Male; Age: Aged 25 years; measures: Value,352100,18202,370302
TS009,9240,Sex: Male; Age: Aged 26 years; measures: Value,357358,18105,375463
TS009,9241,Sex: Male; Age: Aged 27 years; measures: Value,363060,18338,381398
TS009,9242,Sex: Male; Age: Aged 28 years; measures: Value,368101,18526,386627
TS009,9243,Sex: Male; Age: Aged 29 years; measures: Value,377284,18806,396090
TS009,9244,Sex: Male; Age: Aged 30 years; measures: Value,387693,19533,407226
TS009,9245,Sex: Male; Age: Aged 31 years; measures: Value,381717,18910,400627
TS009,9246,Sex: Male; Age: Aged 32 years; measures: Value,381223,19111,400334
TS009,9247,Sex: Male; Age: Aged 33 years; measures: Value,385226,18857,404083
TS009,9248,Sex: Male; Age: Aged 34 years; measures: Value,372366,18982,391348
TS009,9249,Sex: Male; Age: Aged 35 to 49 years; measures: Value,5372629,267063,5639692
TS009,9250,Sex: Male; Age: Aged 35 years; measures: Value,376400,18432,394832
TS009,9251,Sex: Male; Age: Aged 36 years; measures: Value,371330,18394,389724
TS009,9252,Sex: Male; Age: Aged 37 years; measures: Value,365391,17850,383241
TS009,9253,Sex: Male; Age: Aged 38 years; measures: Value,363600,17882,381482
TS009,9254,Sex: Male; Age: Aged 39 years; measures: Value,365168,17762,382930
TS009,9255,Sex: Male; Age: Aged 40 years; measures: Value,372707,18258,390965
TS009,9256,Sex: Male; Age: Aged 41 years; measures: Value,368234,18386,386620
TS009,9257,Sex: Male; Age: Aged 42 years; measures: Value,350513,16932,367445
TS009,9258,Sex: Male; Age: Aged 43 years; measures: Value,330761,15932,346693
TS009,9259,Sex: Male; Age: Aged 44 years; measures: Value,331459,16361,347820
TS009,9260,Sex: Male; Age: Aged 45 years; measures: Value,336594,16531,353125
TS009,9261,Sex: Male; Age: Aged 46 years; measures: Value,345216,17371,362587
TS009,9262,Sex: Male; Age: Aged 47 years; measures: Value,350575,17614,368189
TS009,9263,Sex: Male; Age: Aged 48 years; measures: Value,365311,18928,384239
TS009,9264,Sex: Male; Age: Aged 49 years; measures: Value,379370,20430,399800
TS009,9265,Sex: Male; Age: Aged 50 to 64 years; measures: Value,5394506,310926,5705432
TS009,9266,Sex: Male; Age: Aged 50 years; measures: Value,385514,20805,406319
TS009,9267,Sex: Male; Age: Aged 51 years; measures: Value,378726,20520,399246
TS009,9268,Sex: Male; Age: Aged 52 years; measures: Value,386730,21271,408001
TS009,9269,Sex: Male; Age: Aged 53 years; measures: Value,384208,20764,404972
TS009,9270,Sex: Male; Age: Aged 54 years; measures: Value,387703,21339,409042
TS009,9271,Sex: Male; Age: Aged 55 years; measures: Value,384851,21770,406621
TS009,9272,Sex: Male; Age: Aged 56 years; measures: Value,385213,22364,407577
TS009,9273,Sex: Male; Age: Aged 57 years; measures: Value,375671,21855,397526
TS009,9274,Sex: Male; Age: Aged 58 years; measures: Value,367810,21572,389382
TS009,9275,Sex: Male; Age: Aged 59 years; measures: Value,356109,21042,377151
TS009,9276,Sex: Male; Age: Aged 60 years; measures: Value,346532,20516,367048
TS009,9277,Sex: Male; Age: Aged 61 years; measures: Value,328537,19849,348386
TS009,9278,Sex: Male; Age: Aged 62 years; measures: Value,320323,19724,340047
TS009,9279,Sex: Male; Age: Aged 63 years; measures: Value,311108,19155,330263
TS009,9280,Sex: Male; Age: Aged 64 years; measures: Value,295471,18380,313851
TS009,9281,Sex: Male; Age: Aged 65 to 74 years; measures: Value,2673653,173985,2847638
TS009,9282,Sex: Male; Age: Aged 65 years; measures: Value,281749,17316,299065
TS009,9283,Sex: Male; Age: Aged 66 years; measures: Value,272257,17326,289583
TS009,9284,Sex: Male; Age: Aged 67 years; measures: Value,271683,17670,289353
TS009,9285,Sex: Male; Age: Aged 68 years; measures: Value,260935,17177,278112
TS009,9286,Sex: Male; Age: Aged 69 years; measures: Value,255271,16759,272030
TS009,9287,Sex: Male; Age: Aged 70 years; measures: Value,254127,16799,270926
TS009,9288,Sex: Male; Age: Aged 71 years; measures: Value,256837,17376,274213
TS009,9289,Sex: Male; Age: Aged 72 years; measures: Value,261219,17356,278575
TS009,9290,Sex: Male; Age: Aged 73 years; measures: Value,281622,18531,300153
TS009,9291,Sex: Male; Age: Aged 74 years; measures: Value,277953,17675,295628
TS009,9292,Sex: Male; Age: Aged 75 to 84 years; measures: Value,1574786,101158,1675944
TS009,9293,Sex: Male; Age: Aged 75 years; measures: Value,207735,13381,221116
TS009,9294,Sex: Male; Age: Aged 76 years; measures: Value,216062,13885,229947
TS009,9295,Sex: Male; Age: Aged 77 years; measures: Value,195446,12721,208167
TS009,9296,Sex: Male; Age: Aged 78 years; measures: Value,178771,11718,190489
TS009,9297,Sex: Male; Age: Aged 79 years; measures: Value,149206,9955,159161
TS009,9298,Sex: Male; Age: Aged 80 years; measures: Value,137733,9129,146862
TS009,9299,Sex: Male; Age: Aged 81 years; measures: Value,137721,8677,146398
TS009,9300,Sex: Male; Age: Aged 82 years; measures: Value,128782,7956,136738
TS009,9301,Sex: Male; Age: Aged 83 years; measures: Value,117552,7258,124810
TS009,9302,Sex: Male; Age: Aged 84 years; measures: Value,105778,6478,112256
TS009,9303,Sex: Male; Age: Aged 85 years and over; measures: Value,512225,30770,542995
TS009,9304,Sex: Male; Age: Aged 85 years; measures: Value,92256,5651,97907
TS009,9305,Sex: Male; Age: Aged 86 years; measures: Value,80784,5028,85812
TS009,9306,Sex: Male; Age: Aged 87 years; measures: Value,68640,4103,72743
TS009,9307,Sex: Male; Age: Aged 88 years; measures: Value,59533,3568,63101
TS009,9308,Sex: Male; Age: Aged 89 years; measures: Value,50378,2905,53283
TS009,9309,Sex: Male; Age: Aged 90 years and over; measures: Value,160634,9515,170149
TS010,10001,Living arrangements: Total; measures: Value,45055713,2504343,47560056
TS010,10002,Living arrangements: Living in a couple; measures: Value,26061947,1442209,27504156
TS010,10003,Living arrangements: Living in a couple: Married or in a civil partnership; measures: Value,19678351,1084631,20762982
TS010,10004,Living arrangements: Living in a couple: Married or in a civil partnership: Opposite-sex couple; measures: Value,19527894,1076806,20604700
TS010,10005,Living arrangements: Living in a couple: Married or in a civil partnership: Same-sex couple; measures: Value,150457,7825,158282
TS010,10006,"Living arrangements: Living in a couple: Separated, but still married or in a civil partnership; measures: Value",45430,1948,47378
TS010,10007,Living arrangements: Living in a couple: Cohabiting; measures: Value,6338166,355630,6693796
TS010,10008,Living arrangements: Living in a couple: Cohabiting: Opposite-sex couple; measures: Value,6037645,338043,6375688
TS010,10009,Living arrangements: Living in a couple: Cohabiting: Same-sex couple; measures: Value,300521,17587,318108
TS010,10010,Living arrangements: Not living in a couple; measures: Value,18993766,1062134,20055900
TS010,10011,Living arrangements: Not living in a couple: Single (never married and never registered a same-sex civil partnership); measures: Value,12033243,648600,12681843
TS010,10012,Living arrangements: Not living in a couple: Married or in a registered civil partnership; measures: Value,629782,23005,652787
TS010,10013,Living arrangements: Not living in a couple: Separated (including those who are married and those who are in civil partnerships); measures: Value,841374,43593,884967
TS010,10014,Living arrangements: Not living in a couple: Divorced or formerly in a civil partnership which is now legally dissolved; measures: Value,2976356,182788,3159144
TS010,10015,Living arrangements: Not living in a couple: Widowed or surviving partner from a civil partnership; measures: Value,2513011,164148,2677159
TS011,11001,Household deprivation: Total: All households; measures: Value,23434887,1347207,24782094
TS011,11002,Household deprivation: Household is not deprived in any dimension; measures: Value,11349246,618582,11967828
TS011,11003,Household deprivation: Household is deprived in one dimension; measures: Value,7842232,450110,8292342
TS011,11004,Household deprivation: Household is deprived in two dimensions; measures: Value,3320730,215515,3536245
TS011,11005,Household deprivation: Household is deprived in three dimensions; measures: Value,867803,60597,928400
TS011,11006,Household deprivation: Household is deprived in four dimensions; measures: Value,54876,2403,57279
TS012,12001,Country of birth: Total: All usual residents; measures: Value,56490047,3107507,59597554
TS012,12002,Country of birth: Europe; measures: Value,50730083,2992198,53722281
TS012,12003,Country of birth: Europe: United Kingdom; measures: Value,46687516,2892061,49579577
TS012,12004,Country of birth: Europe: United Kingdom: England; measures: Value,45388721,659084,46047805
TS012,12005,Country of birth: Europe: United Kingdom: Northern Ireland; measures: Value,190544,7804,198348
TS012,12006,Country of birth: Europe: United Kingdom: Scotland; measures: Value,626451,21975,648426
TS012,12007,Country of birth: Europe: United Kingdom: Wales; measures: Value,478699,2202816,2681515
TS012,12008,Country of birth: Europe: United Kingdom: Great Britain not otherwise specified; measures: Value,484,95,579
TS012,12009,Country of birth: Europe: United Kingdom: United Kingdom not otherwise specified; measures: Value,2617,287,2904
TS012,12010,Country of birth: Europe: Other Europe; measures: Value,4042567,100137,4142704
TS012,12011,Country of birth: Europe: Other Europe: EU countries; measures: Value,3551497,91474,3642971
TS012,12012,Country of birth: Europe: Other Europe: EU countries: Member countries in March 2001; measures: Value,1578407,41592,1619999
TS012,12013,Country of birth: Europe: Other Europe: EU countries: Member countries in March 2001: Ireland; measures: Value,314682,9998,324680
TS012,12014,Country of birth: Europe: Other Europe: EU countries: Member countries in March 2001: France; measures: Value,152692,2625,155317
TS012,12015,Country of birth: Europe: Other Europe: EU countries: Member countries in March 2001: Germany; measures: Value,252260,11112,263372
TS012,12016,Country of birth: Europe: Other Europe: EU countries: Member countries in March 2001: Italy; measures: Value,272019,4650,276669
TS012,12017,Country of birth: Europe: Other Europe: EU countries: Member countries in March 2001: Portugal (including Madeira and the Azores); measures: Value,152642,3667,156309
TS012,12018,Country of birth: Europe: Other Europe: EU countries: Member countries in March 2001: Spain (including Canary Islands); measures: Value,163845,3069,166914
TS012,12019,Country of birth: Europe: Other Europe: EU countries: Member countries in March 2001: Other member countries in March 2001; measures: Value,270267,6471,276738
TS012,12020,Country of birth: Europe: Other Europe: EU countries: Countries that joined the EU between April 2001 and March 2011; measures: Value,1960537,49620,2010157
TS012,12021,Country of birth: Europe: Other Europe: EU countries: Countries that joined the EU between April 2001 and March 2011: Lithuania; measures: Value,161602,2563,164165
TS012,12022,Country of birth: Europe: Other Europe: EU countries: Countries that joined the EU between April 2001 and March 2011: Poland; measures: Value,718244,24830,743074
TS012,12023,Country of birth: Europe: Other Europe: EU countries: Countries that joined the EU between April 2001 and March 2011: Romania; measures: Value,530328,8517,538845
TS012,12024,Country of birth: Europe: Other Europe: EU countries: Countries that joined the EU between April 2001 and March 2011: Other EU countries; measures: Value,550363,13710,564073
TS012,12025,Country of birth: Europe: Other Europe: EU countries: Countries that joined the EU between April 2011 and March 2021; measures: Value,12553,262,12815
TS012,12026,Country of birth: Europe: Other Europe: EU countries: Countries that joined the EU between April 2011 and March 2021: Croatia; measures: Value,12553,262,12815
TS012,12027,Country of birth: Europe: Other Europe: Rest of Europe; measures: Value,491070,8663,499733
TS012,12028,Country of birth: Europe: Other Europe: Rest of Europe: Turkey; measures: Value,124760,2881,127641
TS012,12029,Country of birth: Europe: Other Europe: Rest of Europe: Other Europe; measures: Value,366310,5782,372092
TS012,12030,Country of birth: Africa; measures: Value,1558193,28771,1586964
TS012,12031,Country of birth: Africa: North Africa; measures: Value,165177,5431,170608
TS012,12032,Country of birth: Africa: Central and Western Africa; measures: Value,551745,7016,558761
TS012,12033,Country of birth: Africa: Central and Western Africa: Ghana; measures: Value,131752,824,132576
TS012,12034,Country of birth: Africa: Central and Western Africa: Nigeria; measures: Value,266879,3893,270772
TS012,12035,Country of birth: Africa: Central and Western Africa: Other Central and Western Africa; measures: Value,153114,2299,155413
TS012,12036,Country of birth: Africa: South and Eastern Africa; measures: Value,836308,16213,852521
TS012,12037,Country of birth: Africa: South and Eastern Africa: Kenya; measures: Value,133402,1534,134936
TS012,12038,Country of birth: Africa: South and Eastern Africa: Somalia; measures: Value,106909,2009,108918
TS012,12039,Country of birth: Africa: South and Eastern Africa: South Africa; measures: Value,211449,5733,217182
TS012,12040,Country of birth: Africa: South and Eastern Africa: Zimbabwe; measures: Value,121356,2800,124156
TS012,12041,Country of birth: Africa: South and Eastern Africa: Other South and Eastern Africa; measures: Value,263192,4137,267329
TS012,12042,Country of birth: Africa: Africa not otherwise specified; measures: Value,4963,111,5074
TS012,12043,Country of birth: Middle East and Asia; measures: Value,3241660,69325,3310985
TS012,12044,Country of birth: Middle East and Asia: Middle East; measures: Value,396002,13693,409695
TS012,12045,Country of birth: Middle East and Asia: Middle East: Iran; measures: Value,106807,2367,109174
TS012,12046,Country of birth: Middle East and Asia: Middle East: Iraq; measures: Value,86231,3164,89395
TS012,12047,Country of birth: Middle East and Asia: Middle East: Other Middle East; measures: Value,202964,8162,211126
TS012,12048,Country of birth: Middle East and Asia: Eastern Asia; measures: Value,361945,11239,373184
TS012,12049,Country of birth: Middle East and Asia: Eastern Asia: China; measures: Value,176072,6304,182376
TS012,12050,Country of birth: Middle East and Asia: Eastern Asia: Hong Kong (Special Administrative Region of China); measures: Value,117718,3714,121432
TS012,12051,Country of birth: Middle East and Asia: Eastern Asia: Other Eastern Asia; measures: Value,68155,1221,69376
TS012,12052,Country of birth: Middle East and Asia: Southern Asia; measures: Value,2094911,31815,2126726
TS012,12053,Country of birth: Middle East and Asia: Southern Asia: Afghanistan; measures: Value,84873,814,85687
TS012,12054,Country of birth: Middle East and Asia: Southern Asia: India; measures: Value,906961,13399,920360
TS012,12055,Country of birth: Middle East and Asia: Southern Asia: Pakistan; measures: Value,616464,7104,623568
TS012,12056,Country of birth: Middle East and Asia: Southern Asia: Bangladesh; measures: Value,266306,6751,273057
TS012,12057,Country of birth: Middle East and Asia: Southern Asia: Sri Lanka; measures: Value,141844,2439,144283
TS012,12058,Country of birth: Middle East and Asia: Southern Asia: Other Southern Asia; measures: Value,78463,1308,79771
TS012,12059,Country of birth: Middle East and Asia: South-East Asia; measures: Value,376496,12346,388842
TS012,12060,Country of birth: Middle East and Asia: South-East Asia: Philippines; measures: Value,149463,5537,155000
TS012,12061,Country of birth: Middle East and Asia: South-East Asia: Malaysia; measures: Value,59685,1838,61523
TS012,12062,Country of birth: Middle East and Asia: South-East Asia: Singapore; measures: Value,39619,1287,40906
TS012,12063,Country of birth: Middle East and Asia: South-East Asia: Other South-East Asia; measures: Value,127729,3684,131413
TS012,12064,Country of birth: Middle East and Asia: Central Asia; measures: Value,12306,232,12538
TS012,12065,Country of birth: The Americas and the Caribbean; measures: Value,789989,12636,802625
TS012,12066,Country of birth: The Americas and the Caribbean: North America; measures: Value,271273,7017,278290
TS012,12067,Country of birth: The Americas and the Caribbean: North America: United States; measures: Value,198646,4627,203273
TS012,12068,Country of birth: The Americas and the Caribbean: North America: Canada; measures: Value,66841,2246,69087
TS012,12069,Country of birth: The Americas and the Caribbean: North America: Other North America; measures: Value,5786,144,5930
TS012,12070,Country of birth: The Americas and the Caribbean: Central America; measures: Value,22938,640,23578
TS012,12071,Country of birth: The Americas and the Caribbean: Central America: All Central American countries; measures: Value,22938,640,23578
TS012,12072,Country of birth: The Americas and the Caribbean: South America; measures: Value,251256,2969,254225
TS012,12073,Country of birth: The Americas and the Caribbean: South America: All South American countries; measures: Value,251256,2969,254225
TS012,12074,Country of birth: The Americas and the Caribbean: The Caribbean; measures: Value,244522,2010,246532
TS012,12075,Country of birth: The Americas and the Caribbean: The Caribbean: Jamaica; measures: Value,141289,867,142156
TS012,12076,Country of birth: The Americas and the Caribbean: The Caribbean: Other Caribbean; measures: Value,103233,1143,104376
TS012,12077,Country of birth: Antarctica and Oceania; measures: Value,170039,4577,174616
TS012,12078,Country of birth: Antarctica and Oceania: Australasia; measures: Value,157855,4320,162175
TS012,12079,Country of birth: Antarctica and Oceania: Australasia: Australia; measures: Value,109962,3008,112970
TS012,12080,Country of birth: Antarctica and Oceania: Australasia: New Zealand; measures: Value,47846,1311,49157
TS012,12081,Country of birth: Antarctica and Oceania: Australasia: Other Australasia; measures: Value,47,1,48
TS012,12082,Country of birth: Antarctica and Oceania: Other Oceania and Antarctica; measures: Value,12184,257,12441
TS012,12083,Country of birth: Other; measures: Value,83,0,83
TS013,13001,Passports held: Total: All usual residents; measures: Value,56490287,3107575,59597862
TS013,13002,Passports held: Europe; measures: Value,47259823,2485785,49745608
TS013,13003,Passports held: Europe: United Kingdom; measures: Value,43288679,2399777,45688456
TS013,13004,Passports held: Europe: Ireland; measures: Value,354928,9810,364738
TS013,13005,Passports held: Europe: Other Europe; measures: Value,3616216,76198,3692414
TS013,13006,Passports held: Europe: Other Europe: EU Member countries; measures: Value,3447212,73245,3520457
TS013,13007,Passports held: Europe: Other Europe: EU Member countries: France; measures: Value,161423,2123,163546
TS013,13008,Passports held: Europe: Other Europe: EU Member countries: Germany; measures: Value,116594,2842,119436
TS013,13009,Passports held: Europe: Other Europe: EU Member countries: Italy; measures: Value,363838,4834,368672
TS013,13010,Passports held: Europe: Other Europe: EU Member countries: Portugal; measures: Value,281861,4630,286491
TS013,13011,Passports held: Europe: Other Europe: EU Member countries: Spain; measures: Value,213808,2879,216687
TS013,13012,Passports held: Europe: Other Europe: EU Member countries: Lithuania; measures: Value,182324,2807,185131
TS013,13013,Passports held: Europe: Other Europe: EU Member countries: Poland; measures: Value,734460,25763,760223
TS013,13014,Passports held: Europe: Other Europe: EU Member countries: Romania; measures: Value,542398,7847,550245
TS013,13015,Passports held: Europe: Other Europe: EU Member countries: Other EU countries; measures: Value,850506,19520,870026
TS013,13016,Passports held: Europe: Other Europe: Rest of Europe; measures: Value,169004,2953,171957
TS013,13017,Passports held: Europe: Other Europe: Rest of Europe: Turkey; measures: Value,44254,1210,45464
TS013,13018,Passports held: Europe: Other Europe: Rest of Europe: Other Europe; measures: Value,124750,1743,126493
TS013,13019,Passports held: Africa; measures: Value,370167,8173,378340
TS013,13020,Passports held: Africa: North Africa; measures: Value,52316,2058,54374
TS013,13021,Passports held: Africa: Central and Western Africa; measures: Value,191829,3259,195088
TS013,13022,Passports held: Africa: Central and Western Africa: Ghana; measures: Value,47621,344,47965
TS013,13023,Passports held: Africa: Central and Western Africa: Nigeria; measures: Value,115191,2421,117612
TS013,13024,Passports held: Africa: Central and Western Africa: Other Central and Western Africa; measures: Value,29017,494,29511
TS013,13025,Passports held: Africa: South and Eastern Africa; measures: Value,126022,2856,128878
TS013,13026,Passports held: Africa: South and Eastern Africa: Kenya; measures: Value,10378,233,10611
TS013,13027,Passports held: Africa: South and Eastern Africa: Somalia; measures: Value,2106,33,2139
TS013,13028,Passports held: Africa: South and Eastern Africa: South Africa; measures: Value,49336,1123,50459
TS013,13029,Passports held: Africa: South and Eastern Africa: Zimbabwe; measures: Value,29322,702,30024
TS013,13030,Passports held: Africa: South and Eastern Africa: Other South and Eastern Africa; measures: Value,34880,765,35645
TS013,13031,Passports held: Middle East and Asia; measures: Value,1052403,23956,1076359
TS013,13032,Passports held: Middle East and Asia: Middle East; measures: Value,68797,3309,72106
TS013,13033,Passports held: Middle East and Asia: Middle East: Iran; measures: Value,16055,382,16437
TS013,13034,Passports held: Middle East and Asia: Middle East: Iraq; measures: Value,9799,474,10273
TS013,13035,Passports held: Middle East and Asia: Middle East: Other Middle East; measures: Value,42943,2453,45396
TS013,13036,Passports held: Middle East and Asia: Eastern Asia; measures: Value,169867,5027,174894
TS013,13037,Passports held: Middle East and Asia: Eastern Asia: China; measures: Value,105180,3698,108878
TS013,13038,Passports held: Middle East and Asia: Eastern Asia: Hong Kong (Special Administrative Region of China); measures: Value,18884,599,19483
TS013,13039,Passports held: Middle East and Asia: Eastern Asia: Japan; measures: Value,27401,448,27849
TS013,13040,Passports held: Middle East and Asia: Eastern Asia: Other Eastern Asia; measures: Value,18402,282,18684
TS013,13041,Passports held: Middle East and Asia: Southern Asia; measures: Value,681822,11752,693574
TS013,13042,Passports held: Middle East and Asia: Southern Asia: Afghanistan; measures: Value,14102,170,14272
TS013,13043,Passports held: Middle East and Asia: Southern Asia: Bangladesh; measures: Value,58868,1613,60481
TS013,13044,Passports held: Middle East and Asia: Southern Asia: India; measures: Value,363295,6000,369295
TS013,13045,Passports held: Middle East and Asia: Southern Asia: Pakistan; measures: Value,164246,2209,166455
TS013,13046,Passports held: Middle East and Asia: Southern Asia: Sri Lanka; measures: Value,34759,939,35698
TS013,13047,Passports held: Middle East and Asia: Southern Asia: Other Southern Asia; measures: Value,46552,821,47373
TS013,13048,Passports held: Middle East and Asia: South-East Asia; measures: Value,127130,3774,130904
TS013,13049,Passports held: Middle East and Asia: South-East Asia: Malaysia; measures: Value,31757,1097,32854
TS013,13050,Passports held: Middle East and Asia: South-East Asia: Philippines; measures: Value,51153,1248,52401
TS013,13051,Passports held: Middle East and Asia: South-East Asia: Singapore; measures: Value,9056,164,9220
TS013,13052,Passports held: Middle East and Asia: South-East Asia: Other South-East Asia; measures: Value,35164,1265,36429
TS013,13053,Passports held: Middle East and Asia: Central Asia; measures: Value,4787,94,4881
TS013,13054,Passports held: The Americas and the Caribbean; measures: Value,295356,4992,300348
TS013,13055,Passports held: The Americas and the Caribbean: North America; measures: Value,154603,3406,158009
TS013,13056,Passports held: The Americas and the Caribbean: North America: Canada; measures: Value,34356,857,35213
TS013,13057,Passports held: The Americas and the Caribbean: North America: United States; measures: Value,120247,2549,122796
TS013,13058,Passports held: The Americas and the Caribbean: Central America; measures: Value,10465,241,10706
TS013,13059,Passports held: The Americas and the Caribbean: South America; measures: Value,85553,974,86527
TS013,13060,Passports held: The Americas and the Caribbean: The Caribbean; measures: Value,44735,371,45106
TS013,13061,Passports held: The Americas and the Caribbean: The Caribbean: Jamaica; measures: Value,28493,175,28668
TS013,13062,Passports held: The Americas and the Caribbean: The Caribbean: Other Caribbean; measures: Value,16242,196,16438
TS013,13063,Passports held: Antarctica and Oceania; measures: Value,75385,1481,76866
TS013,13064,Passports held: Antarctica and Oceania: Australasia; measures: Value,71247,1417,72664
TS013,13065,Passports held: Antarctica and Oceania: Australasia: Australia; measures: Value,50248,930,51178
TS013,13066,Passports held: Antarctica and Oceania: Australasia: New Zealand; measures: Value,20999,487,21486
TS013,13067,Passports held: Antarctica and Oceania: Other Antarctica and Oceania; measures: Value,4138,64,4202
TS013,13068,Passports held: British Overseas Territories; measures: Value,627,10,637
TS013,13069,Passports held: No passport held; measures: Value,7436526,583178,8019704
TS015,15001,Year of arrival in the UK: Total: All usual residents; measures: Value,56490590,3107525,59598115
TS015,15002,Year of arrival in the UK: Born in the UK; measures: Value,46687576,2892027,49579603
TS015,15003,Year of arrival in the UK: Arrived before 1951; measures: Value,71796,2571,74367
TS015,15004,Year of arrival in the UK: Arrived 1951 to 1960; measures: Value,227559,6432,233991
TS015,15005,Year of arrival in the UK: Arrived 1961 to 1970; measures: Value,529789,10588,540377
TS015,15006,Year of arrival in the UK: Arrived 1971 to 1980; measures: Value,543188,11634,554822
TS015,15007,Year of arrival in the UK: Arrived 1981 to 1990; measures: Value,568007,12312,580319
TS015,15008,Year of arrival in the UK: Arrived 1991 to 2000; measures: Value,1070140,19053,1089193
TS015,15009,Year of arrival in the UK: Arrived 2001 to 2010; measures: Value,2633972,62172,2696144
TS015,15010,Year of arrival in the UK: Arrived 2011 to 2013; measures: Value,861021,18543,879564
TS015,15011,Year of arrival in the UK: Arrived 2014 to 2016; measures: Value,1230159,25060,1255219
TS015,15012,Year of arrival in the UK: Arrived 2017 to 2019; measures: Value,1405155,29776,1434931
TS015,15013,Year of arrival in the UK: Arrived 2020 to 2021; measures: Value,662228,17357,679585
TS016,16001,Length of residence in the UK: Total: All usual residents; measures: Value,56490414,3107506,59597920
TS016,16002,Length of residence in the UK: Born in the UK; measures: Value,46687576,2892027,49579603
TS016,16003,Length of residence in the UK: 10 years or more; measures: Value,5708704,126133,5834837
TS016,16004,"Length of residence in the UK: 5 years or more, but less than 10 years; measures: Value",1700031,35423,1735454
TS016,16005,"Length of residence in the UK: 2 years or more, but less than 5 years; measures: Value",1295445,26720,1322165
TS016,16006,Length of residence in the UK: Less than 2 years; measures: Value,1098658,27203,1125861
TS017,17001,Household size: Total: All household spaces; measures: Value,23436139,1346977,24783116
TS017,17002,Household size: 0 people in household; measures: Value,0,0,0
TS017,17003,Household size: 1 person in household; measures: Value,7052433,429556,7481989
TS017,17004,Household size: 2 people in household; measures: Value,7978350,472830,8451180
TS017,17005,Household size: 3 people in household; measures: Value,3743209,212180,3955389
TS017,17006,Household size: 4 people in household; measures: Value,3024636,157390,3182026
TS017,17007,Household size: 5 people in household; measures: Value,1060141,52340,1112481
TS017,17008,Household size: 6 people in household; measures: Value,358847,15239,374086
TS017,17009,Household size: 7 people in household; measures: Value,125792,4710,130502
TS017,17010,Household size: 8 or more people in household; measures: Value,92731,2732,95463
TS018,18001,Age of arrival in the UK: Total: All usual residents; measures: Value,56489386,3107427,59596813
TS018,18002,Age of arrival in the UK: Born in the UK; measures: Value,46687576,2892027,49579603
TS018,18003,Age of arrival in the UK: Arrived in the UK; measures: Value,9801810,215400,10017210
TS018,18004,Age of arrival in the UK: Arrived in the UK: Aged 0 to 4 years; measures: Value,1120340,34282,1154622
TS018,18005,Age of arrival in the UK: Arrived in the UK: Aged 5 to 7 years; measures: Value,428995,10715,439710
TS018,18006,Age of arrival in the UK: Arrived in the UK: Aged 8 to 9 years; measures: Value,266581,6142,272723
TS018,18007,Age of arrival in the UK: Arrived in the UK: Aged 10 to 14 years; measures: Value,618921,13434,632355
TS018,18008,Age of arrival in the UK: Arrived in the UK: Aged 15 years; measures: Value,138924,2846,141770
TS018,18009,Age of arrival in the UK: Arrived in the UK: Aged 16 to 17 years; measures: Value,379984,7975,387959
TS018,18010,Age of arrival in the UK: Arrived in the UK: Aged 18 to 19 years; measures: Value,634831,13774,648605
TS018,18011,Age of arrival in the UK: Arrived in the UK: Aged 20 to 24 years; measures: Value,1851357,37141,1888498
TS018,18012,Age of arrival in the UK: Arrived in the UK: Aged 25 to 29 years; measures: Value,1682017,32813,1714830
TS018,18013,Age of arrival in the UK: Arrived in the UK: Aged 30 to 44 years; measures: Value,2068055,43466,2111521
TS018,18014,Age of arrival in the UK: Arrived in the UK: Aged 45 to 59 years; measures: Value,478796,10088,488884
TS018,18015,Age of arrival in the UK: Arrived in the UK: Aged 60 to 64 years; measures: Value,55914,1154,57068
TS018,18016,Age of arrival in the UK: Arrived in the UK: Aged 65 to 74 years; measures: Value,57736,1166,58902
TS018,18017,Age of arrival in the UK: Arrived in the UK: Aged 75 to 84 years; measures: Value,16388,338,16726
TS018,18018,Age of arrival in the UK: Arrived in the UK: Aged 85 to 89 years; measures: Value,2214,39,2253
TS018,18019,Age of arrival in the UK: Arrived in the UK: Aged 90 years and over; measures: Value,757,27,784
TS019,19001,Migrant indicator: Total: All usual residents; measures: Value,55910406,3079238,58989644
TS019,19002,Migrant indicator: Address one year ago is the same as the address of enumeration; measures: Value,49709609,2786812,52496421
TS019,19003,Migrant indicator: Address one year ago is student term-time or boarding school address in the UK; measures: Value,328934,20020,348954
TS019,19004,Migrant indicator: Migrant from within the UK: Address one year ago was in the UK; measures: Value,5343149,256083,5599232
TS019,19005,Migrant indicator: Migrant from outside the UK: Address one year ago was outside the UK; measures: Value,528714,16323,545037
TS020,20001,Sex: All persons; measures: Value,132372,4057,136429
TS020,20002,Sex: Female; measures: Value,72601,2199,74800
TS020,20003,Sex: Male; measures: Value,59771,1858,61629
TS021,21001,Ethnic group: Total: All usual residents,56490797,3107652,59598449
TS021,21002,"Ethnic group: Asian, Asian British or Asian Welsh",5426729,89163,5515892
TS021,21003,"Ethnic group: Asian, Asian British or Asian Welsh: Bangladeshi",1843200,21100,1864300
TS021,21004,"Ethnic group: Asian, Asian British or Asian Welsh: Chinese",1570515,17525,1588040
TS021,21005,"Ethnic group: Asian, Asian British or Asian Welsh: Indian",629594,15318,644912
TS021,21006,"Ethnic group: Asian, Asian British or Asian Welsh: Pakistani",431037,14491,445528
TS021,21007,"Ethnic group: Asian, Asian British or Asian Welsh: Other Asian",952383,20729,973112
TS021,21008,"Ethnic group: Black, Black British, Black Welsh, Caribbean or African",2381476,27504,2408980
TS021,21009,"Ethnic group: Black, Black British, Black Welsh, Caribbean or African: African",619346,3708,623054
TS021,21010,"Ethnic group: Black, Black British, Black Welsh, Caribbean or African: Caribbean",1468441,19878,1488319
TS021,21011,"Ethnic group: Black, Black British, Black Welsh, Caribbean or African: Other Black",293689,3918,297607
TS021,21012,Ethnic group: Mixed or Multiple ethnic groups,1669771,48568,1718339
TS021,21013,Ethnic group: Mixed or Multiple ethnic groups: White and Asian,499288,13723,513011
TS021,21014,Ethnic group: Mixed or Multiple ethnic groups: White and Black African,241627,8062,249689
TS021,21015,Ethnic group: Mixed or Multiple ethnic groups: White and Black Caribbean,474315,14014,488329
TS021,21016,Ethnic group: Mixed or Multiple ethnic groups: Other Mixed or Multiple ethnic groups,454541,12769,467310
TS021,21017,Ethnic group: White,45783575,2915940,48699515
TS021,21018,"Ethnic group: White: English, Welsh, Scottish, Northern Irish or British",41540730,2814286,44355016
TS021,21019,Ethnic group: White: Irish,494170,13229,507399
TS021,21020,Ethnic group: White: Gypsy or Irish Traveller,64090,3554,67644
TS021,21021,Ethnic group: White: Roma,99334,1849,101183
TS021,21022,Ethnic group: White: Other White,3585251,83022,3668273
TS021,21023,Ethnic group: Other ethnic group,1229246,26477,1255723
TS021,21024,Ethnic group: Other ethnic group: Arab,320140,11634,331774
TS021,21025,Ethnic group: Other ethnic group: Any other ethnic group,909106,14843,923949
TS022,22001,Ethnic group (detailed): Total: All usual residents,56490158,3107532,59597690
TS022,22002,"Ethnic group (detailed): Asian, Asian British or Asian Welsh",5426453,89074,5515527
TS022,22003,"Ethnic group (detailed): Asian, Asian British or Asian Welsh: Afghan",94798,760,95558
TS022,22004,"Ethnic group (detailed): Asian, Asian British or Asian Welsh: African unspecified",3287,27,3314
TS022,22005,"Ethnic group (detailed): Asian, Asian British or Asian Welsh: African Asian",5535,44,5579
TS022,22006,"Ethnic group (detailed): Asian, Asian British or Asian Welsh: Anglo Indian",2039,36,2075
TS022,22007,"Ethnic group (detailed): Asian, Asian British or Asian Welsh: Arab",5014,258,5272
TS022,22008,"Ethnic group (detailed): Asian, Asian British or Asian Welsh: Asian British",15241,388,15629
TS022,22009,"Ethnic group (detailed): Asian, Asian British or Asian Welsh: Bangladeshi, British Bangladeshi",629527,15320,644847
TS022,22010,"Ethnic group (detailed): Asian, Asian British or Asian Welsh: Black and Asian",1952,16,1968
TS022,22011,"Ethnic group (detailed): Asian, Asian British or Asian Welsh: Chinese",431167,14445,445612
TS022,22012,"Ethnic group (detailed): Asian, Asian British or Asian Welsh: English/Welsh/Scottish/Northern Irish/British",2311,64,2375
TS022,22013,"Ethnic group (detailed): Asian, Asian British or Asian Welsh: Filipino",155998,6159,162157
TS022,22014,"Ethnic group (detailed): Asian, Asian British or Asian Welsh: Indian or British Indian",1843296,21075,1864371
TS022,22015,"Ethnic group (detailed): Asian, Asian British or Asian Welsh: Indonesian",7175,197,7372
TS022,22016,"Ethnic group (detailed): Asian, Asian British or Asian Welsh: Iranian",38112,1026,39138
TS022,22017,"Ethnic group (detailed): Asian, Asian British or Asian Welsh: Japanese",29090,484,29574
TS022,22018,"Ethnic group (detailed): Asian, Asian British or Asian Welsh: Kashmiri",39167,63,39230
TS022,22019,"Ethnic group (detailed): Asian, Asian British or Asian Welsh: Korean",20780,345,21125
TS022,22020,"Ethnic group (detailed): Asian, Asian British or Asian Welsh: Kurdish",11848,437,12285
TS022,22021,"Ethnic group (detailed): Asian, Asian British or Asian Welsh: Malaysian",12371,477,12848
TS022,22022,"Ethnic group (detailed): Asian, Asian British or Asian Welsh: Mauritian/Seychellois/Maldivian/Sao Tomean/St Helenian",17066,194,17260
TS022,22023,"Ethnic group (detailed): Asian, Asian British or Asian Welsh: Mixed South Asian",6403,49,6452
TS022,22024,"Ethnic group (detailed): Asian, Asian British or Asian Welsh: Myanmar or Burmese",7329,173,7502
TS022,22025,"Ethnic group (detailed): Asian, Asian British or Asian Welsh: Nepali (includes Gurkha) ",87091,1386,88477
TS022,22026,"Ethnic group (detailed): Asian, Asian British or Asian Welsh: Other Asian, Asian unspecified",22939,374,23313
TS022,22027,"Ethnic group (detailed): Asian, Asian British or Asian Welsh: Other East Asian/ East Asian unspecified",14321,264,14585
TS022,22028,"Ethnic group (detailed): Asian, Asian British or Asian Welsh: Other Middle East",13374,644,14018
TS022,22029,"Ethnic group (detailed): Asian, Asian British or Asian Welsh: Other Mixed",6937,135,7072
TS022,22030,"Ethnic group (detailed): Asian, Asian British or Asian Welsh: Pakistani or British Pakistani",1570291,17534,1587825
TS022,22031,"Ethnic group (detailed): Asian, Asian British or Asian Welsh: Punjabi",8072,64,8136
TS022,22032,"Ethnic group (detailed): Asian, Asian British or Asian Welsh: Sikh",22647,172,22819
TS022,22033,"Ethnic group (detailed): Asian, Asian British or Asian Welsh: Sinhalese",2457,61,2518
TS022,22034,"Ethnic group (detailed): Asian, Asian British or Asian Welsh: Sri Lankan",146899,2352,149251
TS022,22035,"Ethnic group (detailed): Asian, Asian British or Asian Welsh: Taiwanese",4150,71,4221
TS022,22036,"Ethnic group (detailed): Asian, Asian British or Asian Welsh: Tajikistani/Kazakhstani/Kyrgystani/Turkmenistani/Uzbekistani",3619,50,3669
TS022,22037,"Ethnic group (detailed): Asian, Asian British or Asian Welsh: Tamil",45284,627,45911
TS022,22038,"Ethnic group (detailed): Asian, Asian British or Asian Welsh: Thai",38307,1681,39988
TS022,22039,"Ethnic group (detailed): Asian, Asian British or Asian Welsh: Turkish",7354,307,7661
TS022,22040,"Ethnic group (detailed): Asian, Asian British or Asian Welsh: Vietnamese",36622,823,37445
TS022,22041,"Ethnic group (detailed): Asian, Asian British or Asian Welsh: Any other ethnic group",16583,492,17075
TS022,22042,"Ethnic group (detailed): Black, Black British, Black Welsh of African background",1444493,19483,1463976
TS022,22043,"Ethnic group (detailed): Black, Black British, Black Welsh of African background: African unspecified",605338,8189,613527
TS022,22044,"Ethnic group (detailed): Black, Black British, Black Welsh of African background: Angolan ",5137,43,5180
TS022,22045,"Ethnic group (detailed): Black, Black British, Black Welsh of African background: Arab",2864,87,2951
TS022,22046,"Ethnic group (detailed): Black, Black British, Black Welsh of African background: Black British",49121,357,49478
TS022,22047,"Ethnic group (detailed): Black, Black British, Black Welsh of African background: Cameroonian",4072,68,4140
TS022,22048,"Ethnic group (detailed): Black, Black British, Black Welsh of African background: Cote D'Ivoire",2878,18,2896
TS022,22049,"Ethnic group (detailed): Black, Black British, Black Welsh of African background: Democratic Republic of the Congo",24541,243,24784
TS022,22050,"Ethnic group (detailed): Black, Black British, Black Welsh of African background: English/Welsh/Scottish/Northern Irish/British",3640,27,3667
TS022,22051,"Ethnic group (detailed): Black, Black British, Black Welsh of African background: Eritrean",24393,418,24811
TS022,22052,"Ethnic group (detailed): Black, Black British, Black Welsh of African background: Ethiopian",14981,151,15132
TS022,22053,"Ethnic group (detailed): Black, Black British, Black Welsh of African background: Gambian",4107,111,4218
TS022,22054,"Ethnic group (detailed): Black, Black British, Black Welsh of African background: Ghanaian",112455,467,112922
TS022,22055,"Ethnic group (detailed): Black, Black British, Black Welsh of African background: Kenyan",14816,241,15057
TS022,22056,"Ethnic group (detailed): Black, Black British, Black Welsh of African background: Malawian",1746,37,1783
TS022,22057,"Ethnic group (detailed): Black, Black British, Black Welsh of African background: Mauritian/Seychellois/Maldivian/Sao Tomean/St Helenian",3214,55,3269
TS022,22058,"Ethnic group (detailed): Black, Black British, Black Welsh of African background: Mixed Black",1612,12,1624
TS022,22059,"Ethnic group (detailed): Black, Black British, Black Welsh of African background: Moroccan",1749,21,1770
TS022,22060,"Ethnic group (detailed): Black, Black British, Black Welsh of African background: Nigerian",268301,3083,271384
TS022,22061,"Ethnic group (detailed): Black, Black British, Black Welsh of African background: Other Black, Black unspecified",1823,38,1861
TS022,22062,"Ethnic group (detailed): Black, Black British, Black Welsh of African background: Other Mixed",2098,35,2133
TS022,22063,"Ethnic group (detailed): Black, Black British, Black Welsh of African background: Other North African",3593,106,3699
TS022,22064,"Ethnic group (detailed): Black, Black British, Black Welsh of African background: Portuguese",2026,64,2090
TS022,22065,"Ethnic group (detailed): Black, Black British, Black Welsh of African background: Sierra Leone",7715,48,7763
TS022,22066,"Ethnic group (detailed): Black, Black British, Black Welsh of African background: Somali",149108,1558,150666
TS022,22067,"Ethnic group (detailed): Black, Black British, Black Welsh of African background: Somalilander",24084,1396,25480
TS022,22068,"Ethnic group (detailed): Black, Black British, Black Welsh of African background: South African",7744,190,7934
TS022,22069,"Ethnic group (detailed): Black, Black British, Black Welsh of African background: Sudanese",11026,854,11880
TS022,22070,"Ethnic group (detailed): Black, Black British, Black Welsh of African background: Tanzanian",1794,31,1825
TS022,22071,"Ethnic group (detailed): Black, Black British, Black Welsh of African background: Ugandan",16501,109,16610
TS022,22072,"Ethnic group (detailed): Black, Black British, Black Welsh of African background: Zambian",2659,77,2736
TS022,22073,"Ethnic group (detailed): Black, Black British, Black Welsh of African background: Zimbabwean",42824,768,43592
TS022,22074,"Ethnic group (detailed): Black, Black British, Black Welsh of African background: Any other ethnic group ",26533,581,27114
TS022,22075,"Ethnic group (detailed): Black, Black British, Black Welsh or Caribbean background",937412,8062,945474
TS022,22076,"Ethnic group (detailed): Black, Black British, Black Welsh or Caribbean background: African unspecified",24897,431,25328
TS022,22077,"Ethnic group (detailed): Black, Black British, Black Welsh or Caribbean background: Black and European",3151,38,3189
TS022,22078,"Ethnic group (detailed): Black, Black British, Black Welsh or Caribbean background: Black British",194407,2022,196429
TS022,22079,"Ethnic group (detailed): Black, Black British, Black Welsh or Caribbean background: Black/African American",2834,41,2875
TS022,22080,"Ethnic group (detailed): Black, Black British, Black Welsh or Caribbean background: Caribbean",618686,3692,622378
TS022,22081,"Ethnic group (detailed): Black, Black British, Black Welsh or Caribbean background: English/Welsh/Scottish/Northern Irish/British",7613,87,7700
TS022,22082,"Ethnic group (detailed): Black, Black British, Black Welsh or Caribbean background: Ghanaian",2252,7,2259
TS022,22083,"Ethnic group (detailed): Black, Black British, Black Welsh or Caribbean background: Mauritian/Seychellois/Maldivian/Sao Tomean/St Helenian",2013,17,2030
TS022,22084,"Ethnic group (detailed): Black, Black British, Black Welsh or Caribbean background: Mixed Black",12218,81,12299
TS022,22085,"Ethnic group (detailed): Black, Black British, Black Welsh or Caribbean background: Nigerian",4191,36,4227
TS022,22086,"Ethnic group (detailed): Black, Black British, Black Welsh or Caribbean background: Other Black, Black unspecified",36844,617,37461
TS022,22087,"Ethnic group (detailed): Black, Black British, Black Welsh or Caribbean background: Other Mixed",1983,38,2021
TS022,22088,"Ethnic group (detailed): Black, Black British, Black Welsh or Caribbean background: Polynesian/Micronesian/Melanesian",1686,39,1725
TS022,22089,"Ethnic group (detailed): Black, Black British, Black Welsh or Caribbean background: Somali",6263,127,6390
TS022,22090,"Ethnic group (detailed): Black, Black British, Black Welsh or Caribbean background: Any other ethnic group",18374,789,19163
TS022,22091,Ethnic group (detailed): Mixed or Multiple ethnic groups,1669500,48596,1718096
TS022,22092,Ethnic group (detailed): Mixed or Multiple ethnic groups: African unspecified,3770,106,3876
TS022,22093,Ethnic group (detailed): Mixed or Multiple ethnic groups: African Asian,4049,25,4074
TS022,22094,Ethnic group (detailed): Mixed or Multiple ethnic groups: African/Arab,1906,35,1941
TS022,22095,Ethnic group (detailed): Mixed or Multiple ethnic groups: Anglo Indian,2440,44,2484
TS022,22096,Ethnic group (detailed): Mixed or Multiple ethnic groups: Arab,7358,421,7779
TS022,22097,Ethnic group (detailed): Mixed or Multiple ethnic groups: Asian (unspecified) and European,2746,56,2802
TS022,22098,Ethnic group (detailed): Mixed or Multiple ethnic groups: Black and Asian,14198,168,14366
TS022,22099,Ethnic group (detailed): Mixed or Multiple ethnic groups: Black and European,2151,33,2184
TS022,22100,Ethnic group (detailed): Mixed or Multiple ethnic groups: Black and White (unspecified),17603,484,18087
TS022,22101,Ethnic group (detailed): Mixed or Multiple ethnic groups: Black British,2013,37,2050
TS022,22102,Ethnic group (detailed): Mixed or Multiple ethnic groups: Brazilian,6474,123,6597
TS022,22103,Ethnic group (detailed): Mixed or Multiple ethnic groups: Caribbean,7465,122,7587
TS022,22104,Ethnic group (detailed): Mixed or Multiple ethnic groups: Caribbean Asian,7422,74,7496
TS022,22105,Ethnic group (detailed): Mixed or Multiple ethnic groups: Chinese,2826,57,2883
TS022,22106,Ethnic group (detailed): Mixed or Multiple ethnic groups: Chinese and other Asian,1840,89,1929
TS022,22107,Ethnic group (detailed): Mixed or Multiple ethnic groups: Chinese and White,7465,174,7639
TS022,22108,Ethnic group (detailed): Mixed or Multiple ethnic groups: English,3734,58,3792
TS022,22109,Ethnic group (detailed): Mixed or Multiple ethnic groups: English/Welsh/Scottish/Northern Irish/British,11493,373,11866
TS022,22110,Ethnic group (detailed): Mixed or Multiple ethnic groups: European and Black African,3385,71,3456
TS022,22111,Ethnic group (detailed): Mixed or Multiple ethnic groups: European and Black Caribbean,2236,30,2266
TS022,22112,Ethnic group (detailed): Mixed or Multiple ethnic groups: European and North African or Middle Eastern,2949,49,2998
TS022,22113,"Ethnic group (detailed): Mixed or Multiple ethnic groups: European Mixed, European unspecified, other European",25838,700,26538
TS022,22114,Ethnic group (detailed): Mixed or Multiple ethnic groups: Greek Cypriot,1943,32,1975
TS022,22115,Ethnic group (detailed): Mixed or Multiple ethnic groups: Hispanic or Latin American,27569,516,28085
TS022,22116,Ethnic group (detailed): Mixed or Multiple ethnic groups: Indian or British Indian,3394,91,3485
TS022,22117,Ethnic group (detailed): Mixed or Multiple ethnic groups: Iranian,5216,141,5357
TS022,22118,Ethnic group (detailed): Mixed or Multiple ethnic groups: Italian,2053,180,2233
TS022,22119,Ethnic group (detailed): Mixed or Multiple ethnic groups: Jewish,2566,45,2611
TS022,22120,Ethnic group (detailed): Mixed or Multiple ethnic groups: Mauritian/Seychellois/Maldivian/Sao Tomean/St Helenian,5654,73,5727
TS022,22121,Ethnic group (detailed): Mixed or Multiple ethnic groups: Mexican,2581,66,2647
TS022,22122,Ethnic group (detailed): Mixed or Multiple ethnic groups: Mixed Black,4913,64,4977
TS022,22123,Ethnic group (detailed): Mixed or Multiple ethnic groups: Mixed Irish,4344,104,4448
TS022,22124,Ethnic group (detailed): Mixed or Multiple ethnic groups: Mixed South Asian,1961,28,1989
TS022,22125,Ethnic group (detailed): Mixed or Multiple ethnic groups: Mixed White,6232,160,6392
TS022,22126,Ethnic group (detailed): Mixed or Multiple ethnic groups: Moroccan,1825,38,1863
TS022,22127,"Ethnic group (detailed): Mixed or Multiple ethnic groups: Other Asian, Asian unspecified",2764,51,2815
TS022,22128,Ethnic group (detailed): Mixed or Multiple ethnic groups: Other Middle East,3522,121,3643
TS022,22129,Ethnic group (detailed): Mixed or Multiple ethnic groups: Other Mixed,105435,2539,107974
TS022,22130,"Ethnic group (detailed): Mixed or Multiple ethnic groups: Other White, White unspecified",10342,797,11139
TS022,22131,Ethnic group (detailed): Mixed or Multiple ethnic groups: Pakistani or British Pakistani,1657,27,1684
TS022,22132,Ethnic group (detailed): Mixed or Multiple ethnic groups: Polynesian/Micronesian/Melanesian,4694,187,4881
TS022,22133,Ethnic group (detailed): Mixed or Multiple ethnic groups: Portuguese,2397,95,2492
TS022,22134,Ethnic group (detailed): Mixed or Multiple ethnic groups: South African,1570,32,1602
TS022,22135,Ethnic group (detailed): Mixed or Multiple ethnic groups: South American,5877,112,5989
TS022,22136,Ethnic group (detailed): Mixed or Multiple ethnic groups: South Asian and European,2929,38,2967
TS022,22137,Ethnic group (detailed): Mixed or Multiple ethnic groups: Spanish,1772,48,1820
TS022,22138,Ethnic group (detailed): Mixed or Multiple ethnic groups: Turkish,4930,249,5179
TS022,22139,Ethnic group (detailed): Mixed or Multiple ethnic groups: Turkish Cypriot,2003,10,2013
TS022,22140,Ethnic group (detailed): Mixed or Multiple ethnic groups: White African,1953,58,2011
TS022,22141,Ethnic group (detailed): Mixed or Multiple ethnic groups: White and Arab,15545,805,16350
TS022,22142,Ethnic group (detailed): Mixed or Multiple ethnic groups: White and Asian (unspecified),474283,14027,488310
TS022,22143,Ethnic group (detailed): Mixed or Multiple ethnic groups: White and Black African,241611,8076,249687
TS022,22144,Ethnic group (detailed): Mixed or Multiple ethnic groups: White and Black Caribbean,499343,13746,513089
TS022,22145,Ethnic group (detailed): Mixed or Multiple ethnic groups: White and East Asian,3038,81,3119
TS022,22146,Ethnic group (detailed): Mixed or Multiple ethnic groups: White and North African or Middle Eastern,12561,359,12920
TS022,22147,Ethnic group (detailed): Mixed or Multiple ethnic groups: White and South Asian,3749,149,3898
TS022,22148,Ethnic group (detailed): Mixed or Multiple ethnic groups: White Caribbean,2974,86,3060
TS022,22149,Ethnic group (detailed): Mixed or Multiple ethnic groups: Any other ethnic group,52939,2036,54975
TS022,22150,Ethnic group (detailed): White,45783346,2915863,48699209
TS022,22151,Ethnic group (detailed): White: African unspecified,2674,116,2790
TS022,22152,Ethnic group (detailed): White: Albanian,40399,467,40866
TS022,22153,Ethnic group (detailed): White: Algerian,1766,9,1775
TS022,22154,Ethnic group (detailed): White: Arab,3819,126,3945
TS022,22155,Ethnic group (detailed): White: Argentinian,2136,49,2185
TS022,22156,Ethnic group (detailed): White: Armenian,3740,55,3795
TS022,22157,Ethnic group (detailed): White: Australian/New Zealander,59862,1363,61225
TS022,22158,Ethnic group (detailed): White: Austrian,5709,119,5828
TS022,22159,Ethnic group (detailed): White: Belarusian,2475,41,2516
TS022,22160,Ethnic group (detailed): White: Belgian,7392,174,7566
TS022,22161,Ethnic group (detailed): White: Bosnian,2611,17,2628
TS022,22162,Ethnic group (detailed): White: Brazilian,23944,194,24138
TS022,22163,Ethnic group (detailed): White: Bulgarian,87247,2257,89504
TS022,22164,Ethnic group (detailed): White: Colombian,1967,25,1992
TS022,22165,Ethnic group (detailed): White: Cornish,43273,345,43618
TS022,22166,Ethnic group (detailed): White: Croatian,6802,163,6965
TS022,22167,Ethnic group (detailed): White: Cypriot (part not stated),5845,103,5948
TS022,22168,Ethnic group (detailed): White: Czech,23984,1013,24997
TS022,22169,Ethnic group (detailed): White: Danish,9275,182,9457
TS022,22170,Ethnic group (detailed): White: Dutch,22870,825,23695
TS022,22171,"Ethnic group (detailed): White: English, Welsh, Scottish, Northern Irish or British",41497443,2813921,44311364
TS022,22172,Ethnic group (detailed): White: Estonian,4978,136,5114
TS022,22173,Ethnic group (detailed): White: European Mixed,631169,14907,646076
TS022,22174,Ethnic group (detailed): White: Finnish,7716,162,7878
TS022,22175,Ethnic group (detailed): White: French,77261,1300,78561
TS022,22176,Ethnic group (detailed): White: Georgian,2136,41,2177
TS022,22177,Ethnic group (detailed): White: German,64260,1969,66229
TS022,22178,Ethnic group (detailed): White: Greek,72197,1545,73742
TS022,22179,Ethnic group (detailed): White: Greek Cypriot,29103,303,29406
TS022,22180,Ethnic group (detailed): White: Gypsy or Irish Traveller,60012,3374,63386
TS022,22181,Ethnic group (detailed): White: Hispanic or Latin American,31903,460,32363
TS022,22182,Ethnic group (detailed): White: Hungarian,64005,1711,65716
TS022,22183,Ethnic group (detailed): White: Iranian,7257,97,7354
TS022,22184,Ethnic group (detailed): White: Irish,494284,13207,507491
TS022,22185,Ethnic group (detailed): White: Israeli,2964,22,2986
TS022,22186,Ethnic group (detailed): White: Italian,145863,2791,148654
TS022,22187,Ethnic group (detailed): White: Jewish,33852,273,34125
TS022,22188,Ethnic group (detailed): White: Kosovan,13103,27,13130
TS022,22189,Ethnic group (detailed): White: Kurdish,5065,57,5122
TS022,22190,Ethnic group (detailed): White: Latvian,47320,725,48045
TS022,22191,Ethnic group (detailed): White: Lithuanian,95550,1648,97198
TS022,22192,Ethnic group (detailed): White: Maltese,4776,199,4975
TS022,22193,Ethnic group (detailed): White: Mixed Irish,19766,488,20254
TS022,22194,Ethnic group (detailed): White: Mixed White,2925,76,3001
TS022,22195,Ethnic group (detailed): White: Moldovan,3186,20,3206
TS022,22196,Ethnic group (detailed): White: North American,80888,2140,83028
TS022,22197,Ethnic group (detailed): White: North Macedonian,3414,26,3440
TS022,22198,Ethnic group (detailed): White: Norwegian,6569,243,6812
TS022,22199,Ethnic group (detailed): White: Other Eastern European,164174,1905,166079
TS022,22200,Ethnic group (detailed): White: Other Middle East,6379,159,6538
TS022,22201,Ethnic group (detailed): White: Other Mixed,20683,455,21138
TS022,22202,Ethnic group (detailed): White: Other North African,3353,32,3385
TS022,22203,Ethnic group (detailed): White: Other Traveller,4148,178,4326
TS022,22204,"Ethnic group (detailed): White: Other White, White unspecified",207203,4121,211324
TS022,22205,Ethnic group (detailed): White: Polish,592538,21800,614338
TS022,22206,Ethnic group (detailed): White: Portuguese,91540,2101,93641
TS022,22207,Ethnic group (detailed): White: Roma,99148,1844,100992
TS022,22208,Ethnic group (detailed): White: Romanian,337171,5484,342655
TS022,22209,Ethnic group (detailed): White: Russian,43763,894,44657
TS022,22210,Ethnic group (detailed): White: Serbian,7789,108,7897
TS022,22211,Ethnic group (detailed): White: Slovakian,35689,1232,36921
TS022,22212,Ethnic group (detailed): White: Slovenian,3621,103,3724
TS022,22213,Ethnic group (detailed): White: South African,56347,1372,57719
TS022,22214,Ethnic group (detailed): White: South American,6557,62,6619
TS022,22215,Ethnic group (detailed): White: Spanish,79659,1506,81165
TS022,22216,Ethnic group (detailed): White: Swedish,15875,281,16156
TS022,22217,Ethnic group (detailed): White: Swiss,6857,159,7016
TS022,22218,Ethnic group (detailed): White: Turkish,60095,1024,61119
TS022,22219,Ethnic group (detailed): White: Turkish Cypriot,9402,26,9428
TS022,22220,Ethnic group (detailed): White: Ukrainian,16012,222,16234
TS022,22221,Ethnic group (detailed): White: White African,19705,532,20237
TS022,22222,Ethnic group (detailed): White: White and North African or Middle Eastern,1997,29,2026
TS022,22223,Ethnic group (detailed): White: White Caribbean,3407,67,3474
TS022,22224,Ethnic group (detailed): White: Zimbabwean,1739,66,1805
TS022,22225,Ethnic group (detailed): White: Any other ethnic group,21740,590,22330
TS022,22226,Ethnic group (detailed): Other ethnic group,1228954,26454,1255408
TS022,22227,Ethnic group (detailed): Other ethnic group: Afghan,20447,174,20621
TS022,22228,Ethnic group (detailed): Other ethnic group: African unspecified,14193,354,14547
TS022,22229,Ethnic group (detailed): Other ethnic group: African Asian,2425,10,2435
TS022,22230,Ethnic group (detailed): Other ethnic group: Albanian,4676,59,4735
TS022,22231,Ethnic group (detailed): Other ethnic group: Algerian,1730,32,1762
TS022,22232,Ethnic group (detailed): Other ethnic group: Arab,320269,11633,331902
TS022,22233,Ethnic group (detailed): Other ethnic group: Armenian,1991,28,2019
TS022,22234,Ethnic group (detailed): Other ethnic group: Asian British,2059,33,2092
TS022,22235,"Ethnic group (detailed): Other ethnic group: Bangladeshi, British Bangladeshi",2283,162,2445
TS022,22236,Ethnic group (detailed): Other ethnic group: Black and Asian,1911,21,1932
TS022,22237,Ethnic group (detailed): Other ethnic group: Brazilian,5725,59,5784
TS022,22238,Ethnic group (detailed): Other ethnic group: Bulgarian,6599,120,6719
TS022,22239,Ethnic group (detailed): Other ethnic group: Caribbean,2738,27,2765
TS022,22240,Ethnic group (detailed): Other ethnic group: Caribbean Asian,3270,32,3302
TS022,22241,Ethnic group (detailed): Other ethnic group: Chinese,9287,231,9518
TS022,22242,Ethnic group (detailed): Other ethnic group: Colombian,2075,7,2082
TS022,22243,Ethnic group (detailed): Other ethnic group: Cornish,4896,25,4921
TS022,22244,Ethnic group (detailed): Other ethnic group: Cypriot (part not stated),2450,41,2491
TS022,22245,Ethnic group (detailed): Other ethnic group: Czech,2512,189,2701
TS022,22246,Ethnic group (detailed): Other ethnic group: East Asian/ East Asian unspecified,4646,81,4727
TS022,22247,Ethnic group (detailed): Other ethnic group: English,2254,30,2284
TS022,22248,Ethnic group (detailed): Other ethnic group: English/Welsh/Scottish/Northern Irish/British,4754,113,4867
TS022,22249,"Ethnic group (detailed): Other ethnic group: European Mixed, European unspecified, other European",32506,702,33208
TS022,22250,Ethnic group (detailed): Other ethnic group: Filipino,13154,303,13457
TS022,22251,Ethnic group (detailed): Other ethnic group: Greek,3792,75,3867
TS022,22252,Ethnic group (detailed): Other ethnic group: Greek Cypriot,14513,116,14629
TS022,22253,Ethnic group (detailed): Other ethnic group: Gypsy/Romany,1923,25,1948
TS022,22254,Ethnic group (detailed): Other ethnic group: Hispanic or Latin American,74627,967,75594
TS022,22255,Ethnic group (detailed): Other ethnic group: Indian or British Indian,9565,93,9658
TS022,22256,Ethnic group (detailed): Other ethnic group: Iranian,53162,969,54131
TS022,22257,Ethnic group (detailed): Other ethnic group: Italian,4721,77,4798
TS022,22258,Ethnic group (detailed): Other ethnic group: Japanese,2543,38,2581
TS022,22259,Ethnic group (detailed): Other ethnic group: Jewish,31069,222,31291
TS022,22260,Ethnic group (detailed): Other ethnic group: Kashmiri,18804,26,18830
TS022,22261,Ethnic group (detailed): Other ethnic group: Kurdish,73485,2097,75582
TS022,22262,Ethnic group (detailed): Other ethnic group: Lithuanian,2158,13,2171
TS022,22263,Ethnic group (detailed): Other ethnic group: Mauritian/Seychellois/Maldivian/Sao Tomean/St Helenian,12889,93,12982
TS022,22264,Ethnic group (detailed): Other ethnic group: Mexican,1877,44,1921
TS022,22265,Ethnic group (detailed): Other ethnic group: Moroccan,4265,23,4288
TS022,22266,Ethnic group (detailed): Other ethnic group: Muslim,2913,47,2960
TS022,22267,Ethnic group (detailed): Other ethnic group: Nepali (includes Gurkha),15249,194,15443
TS022,22268,Ethnic group (detailed): Other ethnic group: North African,13853,221,14074
TS022,22269,"Ethnic group (detailed): Other ethnic group: Other Asian, Asian unspecified",14573,219,14792
TS022,22270,Ethnic group (detailed): Other ethnic group: Other Eastern European,6768,71,6839
TS022,22271,Ethnic group (detailed): Other ethnic group: Other Middle East,18822,338,19160
TS022,22272,Ethnic group (detailed): Other ethnic group: Other Mixed,14117,442,14559
TS022,22273,"Ethnic group (detailed): Other ethnic group: Other White, White unspecified",7757,108,7865
TS022,22274,Ethnic group (detailed): Other ethnic group: Pakistani or British Pakistani,5174,64,5238
TS022,22275,Ethnic group (detailed): Other ethnic group: Polish,9604,299,9903
TS022,22276,Ethnic group (detailed): Other ethnic group: Polynesia/Micronesia/Melanesia,5033,144,5177
TS022,22277,Ethnic group (detailed): Other ethnic group: Portuguese,4849,95,4944
TS022,22278,Ethnic group (detailed): Other ethnic group: Punjabi,8258,41,8299
TS022,22279,Ethnic group (detailed): Other ethnic group: Roma,1738,31,1769
TS022,22280,Ethnic group (detailed): Other ethnic group: Romanian,21938,313,22251
TS022,22281,Ethnic group (detailed): Other ethnic group: Sikh,76062,511,76573
TS022,22282,Ethnic group (detailed): Other ethnic group: Slovakian,5879,125,6004
TS022,22283,Ethnic group (detailed): Other ethnic group: Somali,11161,135,11296
TS022,22284,Ethnic group (detailed): Other ethnic group: Somalilander,1694,143,1837
TS022,22285,Ethnic group (detailed): Other ethnic group: South American,9630,88,9718
TS022,22286,Ethnic group (detailed): Other ethnic group: Spanish,4011,57,4068
TS022,22287,Ethnic group (detailed): Other ethnic group: Sri Lankan,8015,81,8096
TS022,22288,Ethnic group (detailed): Other ethnic group: Tamil,22931,179,23110
TS022,22289,Ethnic group (detailed): Other ethnic group: Thai,1664,38,1702
TS022,22290,Ethnic group (detailed): Other ethnic group: Turkish,54761,1219,55980
TS022,22291,Ethnic group (detailed): Other ethnic group: Turkish Cypriot,20022,38,20060
TS022,22292,Ethnic group (detailed): Other ethnic group: Vietnamese,3034,28,3062
TS022,22293,Ethnic group (detailed): Other ethnic group: White African,2075,38,2113
TS022,22294,Ethnic group (detailed): Other ethnic group: Any other ethnic group,79126,1803,80929
TS023,23001,Multiple ethnic groups in household: Total: All households,23436770,1347050,24783820
TS023,23002,Multiple ethnic groups in household: One-person household,7052433,429556,7481989
TS023,23003,Multiple ethnic groups in household: All household members have the same ethnic group,13945454,846628,14792082
TS023,23004,Multiple ethnic groups in household: Ethnic groups differ between generations but not within partnerships,424229,11858,436087
TS023,23005,Multiple ethnic groups in household: Ethnic groups differ within partnerships,1382483,42501,1424984
TS023,23006,Multiple ethnic groups in household: Any other combination of multiple ethnic identities,632171,16507,648678
TS024,24001,Main language (detailed): Total: All usual residents aged 3 years and over,54686108,3018176,57704284
TS024,24002,Main language (detailed): English (English or Welsh in Wales),49652192,2917643,52569835
TS024,24003,Main language (detailed): Welsh or Cymraeg (in England only),7350,0,7350
TS024,24004,Main language (detailed): Other UK language,4103,150,4253
TS024,24005,Main language (detailed): Other UK language: Gaelic (Irish),712,39,751
TS024,24006,Main language (detailed): Other UK language: Gaelic (Scottish),161,10,171
TS024,24007,Main language (detailed): Other UK language: Manx Gaelic,6,2,8
TS024,24008,Main language (detailed): Other UK language: Gaelic (Not otherwise specified),261,9,270
TS024,24009,Main language (detailed): Other UK language: Cornish,557,6,563
TS024,24010,Main language (detailed): Other UK language: Scots,513,28,541
TS024,24011,Main language (detailed): Other UK language: Ulster Scots,12,1,13
TS024,24012,Main language (detailed): Other UK language: Romany English,1851,49,1900
TS024,24013,Main language (detailed): Other UK language: Irish Traveller Cant,30,6,36
TS024,24014,Main language (detailed): French,118638,1632,120270
TS024,24015,Main language (detailed): Portuguese,221076,3644,224720
TS024,24016,Main language (detailed): Spanish,211994,3064,215058
TS024,24017,Main language (detailed): Other European language (EU),1815511,42795,1858306
TS024,24018,Main language (detailed): Other European language (EU): Italian,157623,2363,159986
TS024,24019,Main language (detailed): Other European language (EU): German,45200,1212,46412
TS024,24020,Main language (detailed): Other European language (EU): Polish,590968,20863,611831
TS024,24021,Main language (detailed): Other European language (EU): Slovak,48519,1423,49942
TS024,24022,Main language (detailed): Other European language (EU): Czech,28752,1278,30030
TS024,24023,Main language (detailed): Other European language (EU): Romanian,465933,6019,471952
TS024,24024,Main language (detailed): Other European language (EU): Lithuanian,117877,1780,119657
TS024,24025,Main language (detailed): Other European language (EU): Latvian,37875,490,38365
TS024,24026,Main language (detailed): Other European language (EU): Hungarian,85190,2149,87339
TS024,24027,Main language (detailed): Other European language (EU): Bulgarian,108945,2492,111437
TS024,24028,Main language (detailed): Other European language (EU): Greek,75265,1413,76678
TS024,24029,Main language (detailed): Other European language (EU): Dutch,18508,554,19062
TS024,24030,Main language (detailed): Other European language (EU): Swedish,12273,238,12511
TS024,24031,Main language (detailed): Other European language (EU): Danish,5929,102,6031
TS024,24032,Main language (detailed): Other European language (EU): Finnish,4667,80,4747
TS024,24033,Main language (detailed): Other European language (EU): Estonian,2573,69,2642
TS024,24034,Main language (detailed): Other European language (EU): Slovenian,2304,67,2371
TS024,24035,Main language (detailed): Other European language (EU): Maltese,1414,73,1487
TS024,24036,Main language (detailed): Other European language (EU): Any other European language (EU),5696,130,5826
TS024,24037,Main language (detailed): Other European language (non EU),73841,802,74643
TS024,24038,Main language (detailed): Other European language (non EU): Albanian,51888,440,52328
TS024,24039,Main language (detailed): Other European language (non EU): Ukrainian,13981,101,14082
TS024,24040,Main language (detailed): Other European language (non EU): Any other Eastern European language (non EU),352,5,357
TS024,24041,Main language (detailed): Other European language (non EU): Northern European language (non EU),7620,256,7876
TS024,24042,Main language (detailed): Other European language (EU and non-EU),17805,207,18012
TS024,24043,"Main language (detailed): Other European language (EU and non-EU): Bosnian, Croatian, Serbian, and Montenegrin",17805,207,18012
TS024,24044,Main language (detailed): Other European language (non-national),5509,10,5519
TS024,24045,Main language (detailed): Other European language (non-national): Any Romani language,156,10,166
TS024,24046,Main language (detailed): Other European language (non-national): Yiddish,5353,0,5353
TS024,24047,Main language (detailed): Russian,89899,1348,91247
TS024,24048,Main language (detailed): Turkish,110648,2323,112971
TS024,24049,Main language (detailed): Arabic,195483,8518,204001
TS024,24050,Main language (detailed): West or Central Asian language,215362,4032,219394
TS024,24051,Main language (detailed): West or Central Asian language: Hebrew,6612,54,6666
TS024,24052,Main language (detailed): West or Central Asian language: Kurdish,64592,1854,66446
TS024,24053,Main language (detailed): West or Central Asian language: Persian or Farsi,86267,1437,87704
TS024,24054,Main language (detailed): West or Central Asian language: Pashto,48163,543,48706
TS024,24055,Main language (detailed): West or Central Asian language: Any other West or Central Asian language,9728,144,9872
TS024,24056,Main language (detailed): South Asian language,1357555,16590,1374145
TS024,24057,Main language (detailed): South Asian language: Urdu,267624,2239,269863
TS024,24058,Main language (detailed): South Asian language: Hindi,50615,636,51251
TS024,24059,Main language (detailed): South Asian language: Panjabi,288658,2087,290745
TS024,24060,Main language (detailed): South Asian language: Pakistani Pahari (with Mirpuri and Potwari),22789,3,22792
TS024,24061,Main language (detailed): South Asian language: Bengali (with Sylheti and Chatgaya),194820,4671,199491
TS024,24062,Main language (detailed): South Asian language: Gujarati,188212,751,188963
TS024,24063,Main language (detailed): South Asian language: Marathi,10872,156,11028
TS024,24064,Main language (detailed): South Asian language: Telugu,30690,558,31248
TS024,24065,Main language (detailed): South Asian language: Tamil,123747,1637,125384
TS024,24066,Main language (detailed): South Asian language: Malayalam,62982,2022,65004
TS024,24067,Main language (detailed): South Asian language: Sinhala,12707,297,13004
TS024,24068,Main language (detailed): South Asian language: Nepalese,73294,1073,74367
TS024,24069,Main language (detailed): South Asian language: Any other South Asian language,30545,460,31005
TS024,24070,Main language (detailed): East Asian language,350667,11017,361684
TS024,24071,Main language (detailed): East Asian language: Mandarin Chinese,29833,992,30825
TS024,24072,Main language (detailed): East Asian language: Cantonese Chinese,53981,1572,55553
TS024,24073,Main language (detailed): East Asian language: All other Chinese,113945,4330,118275
TS024,24074,Main language (detailed): East Asian language: Japanese,22193,343,22536
TS024,24075,Main language (detailed): East Asian language: Korean,11875,223,12098
TS024,24076,Main language (detailed): East Asian language: Vietnamese,18101,417,18518
TS024,24077,Main language (detailed): East Asian language: Thai,22078,887,22965
TS024,24078,Main language (detailed): East Asian language: Malay,7761,251,8012
TS024,24079,Main language (detailed): East Asian language: Tagalog or Filipino,59123,1772,60895
TS024,24080,Main language (detailed): East Asian language: Any other East Asian language,11777,230,12007
TS024,24081,Main language (detailed): Oceanic or Australian language,1701,23,1724
TS024,24082,Main language (detailed): North or South American language,68,3,71
TS024,24083,Main language (detailed): Caribbean Creole,1769,10,1779
TS024,24084,Main language (detailed): Caribbean Creole: English-based Caribbean Creole,142,1,143
TS024,24085,Main language (detailed): Caribbean Creole: Any other Caribbean Creole,1627,9,1636
TS024,24086,Main language (detailed): African language,202175,2854,205029
TS024,24087,Main language (detailed): African language: Amharic,10647,180,10827
TS024,24088,Main language (detailed): African language: Tigrinya,22334,503,22837
TS024,24089,Main language (detailed): African language: Somali,61376,867,62243
TS024,24090,Main language (detailed): African language: Krio,917,3,920
TS024,24091,Main language (detailed): African language: Akan,19698,55,19753
TS024,24092,Main language (detailed): African language: Yoruba,9826,123,9949
TS024,24093,Main language (detailed): African language: Igbo,10975,103,11078
TS024,24094,Main language (detailed): African language: Swahili or Kiswahili,10037,112,10149
TS024,24095,Main language (detailed): African language: Luganda,2134,14,2148
TS024,24096,Main language (detailed): African language: Lingala,5443,52,5495
TS024,24097,Main language (detailed): African language: Shona,10597,165,10762
TS024,24098,Main language (detailed): African language: Afrikaans,7319,182,7501
TS024,24099,Main language (detailed): African language: Any other Nigerian language,4388,51,4439
TS024,24100,Main language (detailed): African language: Any other West African language,11997,168,12165
TS024,24101,Main language (detailed): African language: Any other African language,14487,276,14763
TS024,24102,Main language (detailed): Sign language,25507,1235,26742
TS024,24103,Main language (detailed): Sign language: British Sign Language,20740,891,21631
TS024,24104,Main language (detailed): Sign language: Any other sign language,1379,153,1532
TS024,24105,Main language (detailed): Sign language: Any sign communication system,3388,191,3579
TS024,24106,Main language (detailed): Other language,7255,276,7531
TS025,25001,Household language (English and Welsh): Total: All households,23436691,1346998,24783689
TS025,25002,"Household language (English and Welsh): All adults in household have English in England, or English or Welsh in Wales as a main language",20920166,1295467,22215633
TS025,25003,"Household language (English and Welsh): At least one but not all adults in household have English in England, or English or Welsh in Wales as a main language",1016730,20443,1037173
TS025,25004,"Household language (English and Welsh): No adults in household, but at least one person aged 3 to 15 years, has English in England or English or Welsh in Wales as a main language",323489,6589,330078
TS025,25005,"Household language (English and Welsh): No people in household have English in England, or English or Welsh in Wales as a main language",1176306,24499,1200805
TS026,26001,Multiple main languages in household: Total: All households,23435762,1347032,24782794
TS026,26002,Multiple main languages in household: One-person household,7052433,429556,7481989
TS026,26003,Multiple main languages in household: All household members have the same main language,14932144,888872,15821016
TS026,26004,"Multiple main languages in household: Main language differs between generations, but not within partnerships",471866,8540,480406
TS026,26005,Multiple main languages in household: Main language differs within partnerships,522528,11846,534374
TS026,26006,Multiple main languages in household: Any other combination of multiple main languages,456791,8218,465009
TS027,27001,National identity: Total: All usual residents,56489515,3107754,59597269
TS027,27002,National identity: British only identity,32102916,574376,32677292
TS027,27003,National identity: English only identity,8615324,283210,8898534
TS027,27004,National identity: English and British only identity,8057384,55092,8112476
TS027,27005,National identity: Welsh only identity,192755,1716000,1908755
TS027,27006,National identity: Welsh and British only identity,86908,250689,337597
TS027,27007,National identity: Any other combination of only UK identities,1296532,119902,1416434
TS027,27008,National identity: Scottish only identity,232279,12272,244551
TS027,27009,National identity: Scottish and British only identity,108568,2090,110658
TS027,27010,National identity: Northern Irish only identity,75433,3615,79048
TS027,27011,National identity: Northern Irish and British only identity,30227,665,30892
TS027,27012,National identity: Cornish only identity,88403,741,89144
TS027,27013,National identity: Cornish and British only identity,10591,93,10684
TS027,27014,National identity: Any other combination of only UK identities,1296532,119902,1416434
TS027,27015,National identity: Irish only identity,290726,8770,299496
TS027,27016,National identity: Irish and at least one UK identity,60281,1988,62269
TS027,27017,National identity: Other identity only,5339104,123041,5462145
TS027,27018,National identity: Other identity and at least one UK identity,1095851,34637,1130488
TS027,27019,National identity: Non-UK identity only,5629830,131811,5761641
TS027,27020,National identity: UK identity and non-UK identity,1156132,36625,1192757
TS028,28001,National identity (detailed): Total: All usual residents,56490189,3107493,59597682
TS028,28002,National identity (detailed): UK identity,50799771,2973705,53773476
TS028,28003,National identity (detailed): UK identity: British only identity,32103285,574336,32677621
TS028,28004,National identity (detailed): UK identity: English only identity,8615431,283289,8898720
TS028,28005,National identity (detailed): UK identity: English and British only identity,8057640,55120,8112760
TS028,28006,National identity (detailed): UK identity:  Welsh only identity,192642,1715972,1908614
TS028,28007,National identity (detailed): UK identity: Welsh and British only identity,86881,250641,337522
TS028,28008,National identity (detailed): UK identity: Scottish only identity,231959,12215,244174
TS028,28009,National identity (detailed): UK identity:  Scottish and British only identity,108691,2068,110759
TS028,28010,National identity (detailed): UK identity: Northern Irish only identity,75467,3615,79082
TS028,28011,National identity (detailed): UK identity: Northern Irish and British only identity,30235,661,30896
TS028,28012,National identity (detailed): UK identity: Cornish only identity,88347,737,89084
TS028,28013,National identity (detailed): UK identity: Cornish and British only identity,10600,88,10688
TS028,28014,National identity (detailed): UK identity: Any other combination of UK identities (UK only),102863,40373,143236
TS028,28015,National identity (detailed): UK identity: Other identity and at least one UK identity,1095730,34590,1130320
TS028,28016,National identity (detailed): Other identity only,5690418,133788,5824206
TS028,28017,National identity (detailed): Other identity only: Guernsey Islander,90,5,95
TS028,28018,National identity (detailed): Other identity only: Jersey Islander,145,18,163
TS028,28019,National identity (detailed): Other identity only: Isle of Man (Manx),1945,163,2108
TS028,28020,National identity (detailed): Other identity only: Channel Islander not otherwise specified,133,10,143
TS028,28021,National identity (detailed): Other identity only: Irish only identity,290771,8746,299517
TS028,28022,National identity (detailed): Other identity only: Irish and at least one UK identity,60297,1973,62270
TS028,28023,National identity (detailed): Other identity only: European,3187806,72798,3260604
TS028,28024,National identity (detailed): Other identity only: European: EU countries,2720706,59600,2780306
TS028,28025,National identity (detailed): Other identity only: European: EU countries: French,126105,1825,127930
TS028,28026,National identity (detailed): Other identity only: European: EU countries: German,83398,2016,85414
TS028,28027,National identity (detailed): Other identity only: European: EU countries: Italian,282818,4054,286872
TS028,28028,National identity (detailed): Other identity only: European: EU countries: Portuguese,232665,4065,236730
TS028,28029,National identity (detailed): Other identity only: European: EU countries: Spanish (including Canary Islander),175055,2376,177431
TS028,28030,National identity (detailed): Other identity only: European: EU countries: Other member countries in March 2001,242354,4275,246629
TS028,28031,National identity (detailed): Other identity only: European: EU countries:  Lithuanian,143763,2267,146030
TS028,28032,National identity (detailed): Other identity only: European: EU countries:  Polish,571738,21271,593009
TS028,28033,National identity (detailed): Other identity only: European: EU countries: Romanian,470271,7092,477363
TS028,28034,National identity (detailed): Other identity only: European: EU countries: Other member countries,392539,10359,402898
TS028,28035,National identity (detailed): Other identity only: European: Non-EU countries,467100,13198,480298
TS028,28036,National identity (detailed): Other identity only: European: Non-EU countries: Turkish,52206,1620,53826
TS028,28037,National identity (detailed): Other identity only: European: Non-EU countries: Other European,414894,11578,426472
TS028,28038,National identity (detailed): Other identity only: African,441149,10618,451767
TS028,28039,National identity (detailed): Other identity only: African: North African,63029,2618,65647
TS028,28040,National identity (detailed): Other identity only: African: Central and Western African,214353,3869,218222
TS028,28041,National identity (detailed): Other identity only: African: Central and Western African: Ghanaian,47025,313,47338
TS028,28042,National identity (detailed): Other identity only: African: Central and Western African: Nigerian,98976,2240,101216
TS028,28043,National identity (detailed): Other identity only: African: Central and Western African: Other Central and Western African,68352,1316,69668
TS028,28044,National identity (detailed): Other identity only: African: South and Eastern African,163767,4131,167898
TS028,28045,National identity (detailed): Other identity only: African: South and Eastern African: Kenyan,9408,233,9641
TS028,28046,National identity (detailed): Other identity only: African: South and Eastern African: Somali,22111,473,22584
TS028,28047,National identity (detailed): Other identity only: African: South and Eastern African: South African,42129,1227,43356
TS028,28048,National identity (detailed): Other identity only: African: South and Eastern African: Zimbabwean,31567,766,32333
TS028,28049,National identity (detailed): Other identity only: African: South and Eastern African: Other South and Eastern African,58552,1432,59984
TS028,28050,National identity (detailed): Other identity only: Middle Eastern and Asian,1256734,31146,1287880
TS028,28051,National identity (detailed): Other identity only: Middle Eastern and Asian: Middle Eastern,142445,6726,149171
TS028,28052,National identity (detailed): Other identity only: Middle Eastern and Asian: Middle Eastern: Kurdish,23116,1099,24215
TS028,28053,National identity (detailed): Other identity only: Middle Eastern and Asian: Middle Eastern: Iranian,35598,964,36562
TS028,28054,National identity (detailed): Other identity only: Middle Eastern and Asian: Middle Eastern: Iraqi,17056,720,17776
TS028,28055,National identity (detailed): Other identity only: Middle Eastern and Asian: Middle Eastern: Other Middle Eastern,66675,3943,70618
TS028,28056,National identity (detailed): Other identity only: Middle Eastern and Asian: Eastern Asian,191568,6243,197811
TS028,28057,National identity (detailed): Other identity only: Middle Eastern and Asian: Eastern Asian: Chinese,119373,4573,123946
TS028,28058,National identity (detailed): Other identity only: Middle Eastern and Asian: Eastern Asian: Hong Kong Chinese,26582,899,27481
TS028,28059,National identity (detailed): Other identity only: Middle Eastern and Asian: Eastern Asian: Japanese,26620,445,27065
TS028,28060,National identity (detailed): Other identity only: Middle Eastern and Asian: Eastern Asian: Other Eastern Asian,18993,326,19319
TS028,28061,National identity (detailed): Other identity only: Middle Eastern and Asian: Southern Asian,746077,12918,758995
TS028,28062,National identity (detailed): Other identity only: Middle Eastern and Asian: Southern Asian: Afghan,30721,378,31099
TS028,28063,National identity (detailed): Other identity only: Middle Eastern and Asian: Southern Asian: Bangladeshi,66815,1878,68693
TS028,28064,National identity (detailed): Other identity only: Middle Eastern and Asian: Southern Asian: Indian,373467,6102,379569
TS028,28065,National identity (detailed): Other identity only: Middle Eastern and Asian: Southern Asian: Pakistani,175410,2422,177832
TS028,28066,National identity (detailed): Other identity only: Middle Eastern and Asian: Southern Asian: Sri Lankan,45673,1171,46844
TS028,28067,National identity (detailed): Other identity only: Middle Eastern and Asian: Southern Asian: Other Southern Asian,53991,967,54958
TS028,28068,National identity (detailed): Other identity only: Middle Eastern and Asian: South-East Asian,132702,4459,137161
TS028,28069,National identity (detailed): Other identity only: Middle Eastern and Asian: South-East Asian: Filipino,54639,1644,56283
TS028,28070,National identity (detailed): Other identity only: Middle Eastern and Asian: South-East Asian: Malaysian,25931,922,26853
TS028,28071,National identity (detailed): Other identity only: Middle Eastern and Asian: South-East Asian: Singaporean,7991,151,8142
TS028,28072,National identity (detailed): Other identity only: Middle Eastern and Asian: South-East Asian: Other South-East Asian,44141,1742,45883
TS028,28073,National identity (detailed): Other identity only: Middle Eastern and Asian: Central Asian,4378,76,4454
TS028,28074,National identity (detailed): Other identity only: Middle Eastern and Asian: Asian not otherwise specified,39564,724,40288
TS028,28075,National identity (detailed): Other identity only: American and Caribbean,292479,5025,297504
TS028,28076,National identity (detailed): Other identity only: American and Caribbean: North American,138727,3041,141768
TS028,28077,National identity (detailed): Other identity only: American and Caribbean: North American: Canadian,30152,792,30944
TS028,28078,National identity (detailed): Other identity only: American and Caribbean: North American: US Citizen,107565,2226,109791
TS028,28079,National identity (detailed): Other identity only: American and Caribbean: North American: Other North American,1010,23,1033
TS028,28080,National identity (detailed): Other identity only: American and Caribbean: Central American,11106,307,11413
TS028,28081,National identity (detailed): Other identity only: American and Caribbean: South American,88377,1103,89480
TS028,28082,National identity (detailed): Other identity only: American and Caribbean: Caribbean,54269,574,54843
TS028,28083,National identity (detailed): Other identity only: American and Caribbean: Caribbean: Jamaican,28815,215,29030
TS028,28084,National identity (detailed): Other identity only: American and Caribbean: Caribbean: Other Caribbean,25454,359,25813
TS028,28085,National identity (detailed): Other identity only: Antarctican and Oceanian,83908,1742,85650
TS028,28086,National identity (detailed): Other identity only: Antarctican and Oceanian: Australasian,79464,1657,81121
TS028,28087,National identity (detailed): Other identity only: Antarctican and Oceanian: Australasian: Australian,54060,1079,55139
TS028,28088,National identity (detailed): Other identity only: Antarctican and Oceanian: Australasian: New Zealander,25233,574,25807
TS028,28089,National identity (detailed): Other identity only: Antarctican and Oceanian: Australasian: Other Australasian,171,4,175
TS028,28090,National identity (detailed): Other identity only: Antarctican and Oceanian: Other Oceanian,4444,85,4529
TS028,28091,National identity (detailed): Other identity only: Other,74961,1544,76505
TS029,29001,Proficiency in English language: Total: All usual residents aged 3 years and over,54686803,3018135,57704938
TS029,29002,Proficiency in English language: Main language is English (English or Welsh in Wales),49652521,2917681,52570202
TS029,29003,Proficiency in English language: Main language is not English (English or Welsh in Wales),5034282,100454,5134736
TS029,29004,Proficiency in English language: Main language is not English (English or Welsh in Wales): Can speak English very well,2212289,43297,2255586
TS029,29005,Proficiency in English language: Main language is not English (English or Welsh in Wales): Can speak English well,1803586,35058,1838644
TS029,29006,Proficiency in English language: Main language is not English (English or Welsh in Wales): Cannot speak English well,861395,18432,879827
TS029,29007,Proficiency in English language: Main language is not English (English or Welsh in Wales): Cannot speak English,157012,3667,160679
TS030,30001,Religion: Total: All usual residents,56490334,3107550,59597884
TS030,30002,Religion: No religion,20715654,1446442,22162096
TS030,30003,Religion: Christian,26167938,1354738,27522676
TS030,30004,Religion: Buddhist,262424,10090,272514
TS030,30005,Religion: Hindu,1020470,12242,1032712
TS030,30006,Religion: Jewish,269245,2048,271293
TS030,30007,Religion: Muslim,3801146,66952,3868098
TS030,30008,Religion: Sikh,519986,4060,524046
TS030,30009,Religion: Other religion,332497,15933,348430
TS030,30010,Religion: Not answered,3400974,195045,3596019
TS031,31001,Religion (detailed): Total: All Usual Residents,56489957,3107532,59597489
TS031,31002,Religion (detailed): Christian,26167916,1354779,27522695
TS031,31003,Religion (detailed): Buddhist,262457,10086,272543
TS031,31004,Religion (detailed): Hindu,1020527,12246,1032773
TS031,31005,Religion (detailed): Jewish,269245,2035,271280
TS031,31006,Religion (detailed): Muslim,3801128,66941,3868069
TS031,31007,Religion (detailed): Sikh,520056,4043,524099
TS031,31008,Religion (detailed): No religion,20715621,1446406,22162027
TS031,31009,Religion (detailed): No religion: Agnostic,30295,1757,32052
TS031,31010,Religion (detailed): No religion: Atheist,13029,803,13832
TS031,31011,Religion (detailed): No religion: Free Thinker,302,15,317
TS031,31012,Religion (detailed): No religion: Humanist,9603,676,10279
TS031,31013,Religion (detailed): No religion: No religion,20662317,1443150,22105467
TS031,31014,Religion (detailed): No religion: Realist,75,5,80
TS031,31015,Religion (detailed): Other religion,332403,15963,348366
TS031,31016,Religion (detailed): Other religion: Alevi,25447,210,25657
TS031,31017,Religion (detailed): Other religion: Animism,726,66,792
TS031,31018,Religion (detailed): Other religion: Baha'i,4484,223,4707
TS031,31019,Religion (detailed): Other religion: Believe in God,2304,102,2406
TS031,31020,Religion (detailed): Other religion: Brahma Kumari,226,6,232
TS031,31021,Religion (detailed): Other religion: Chinese Religion,108,3,111
TS031,31022,Religion (detailed): Other religion: Church of All Religion,20,2,22
TS031,31023,Religion (detailed): Other religion: Confucianist,76,0,76
TS031,31024,Religion (detailed): Other religion: Deist,1039,57,1096
TS031,31025,Religion (detailed): Other religion: Druid,2266,227,2493
TS031,31026,Religion (detailed): Other religion: Druze,620,7,627
TS031,31027,Religion (detailed): Other religion: Eckankar,319,10,329
TS031,31028,Religion (detailed): Other religion: Heathen,4475,238,4713
TS031,31029,Religion (detailed): Other religion: Jain,24887,105,24992
TS031,31030,Religion (detailed): Other religion: Mixed Religion,10979,425,11404
TS031,31031,Religion (detailed): Other religion: Mysticism,138,8,146
TS031,31032,Religion (detailed): Other religion: Native American Church,77,7,84
TS031,31033,Religion (detailed): Other religion: New Age,386,21,407
TS031,31034,Religion (detailed): Other religion: Occult,461,34,495
TS031,31035,Religion (detailed): Other religion: Other religions,63196,2796,65992
TS031,31036,Religion (detailed): Other religion: Own Belief System,2054,133,2187
TS031,31037,Religion (detailed): Other religion: Pagan,68614,5109,73723
TS031,31038,Religion (detailed): Other religion: Pantheism,2131,142,2273
TS031,31039,Religion (detailed): Other religion: Rastafarian,5799,146,5945
TS031,31040,Religion (detailed): Other religion: Ravidassia,9575,8,9583
TS031,31041,Religion (detailed): Other religion: Reconstructionist,700,48,748
TS031,31042,Religion (detailed): Other religion: Satanism,4782,303,5085
TS031,31043,Religion (detailed): Other religion: Scientology,1829,26,1855
TS031,31044,Religion (detailed): Other religion: Shamanism,7649,263,7912
TS031,31045,Religion (detailed): Other religion: Shintoism,1323,35,1358
TS031,31046,Religion (detailed): Other religion: Spiritual,29977,1703,31680
TS031,31047,Religion (detailed): Other religion: Spiritualist,30973,2143,33116
TS031,31048,Religion (detailed): Other religion: Taoist,3503,199,3702
TS031,31049,Religion (detailed): Other religion: Theism,817,31,848
TS031,31050,Religion (detailed): Other religion: Thelemite,210,17,227
TS031,31051,Religion (detailed): Other religion: Traditional African Religion,644,10,654
TS031,31052,Religion (detailed): Other religion: Unification Church,195,7,202
TS031,31053,Religion (detailed): Other religion: Universalist,718,43,761
TS031,31054,Religion (detailed): Other religion: Valmiki,1031,0,1031
TS031,31055,Religion (detailed): Other religion: Vodun,247,11,258
TS031,31056,Religion (detailed): Other religion: Wicca,11991,877,12868
TS031,31057,Religion (detailed): Other religion: Witchcraft,973,82,1055
TS031,31058,Religion (detailed): Other religion: Yazidi,391,20,411
TS031,31059,Religion (detailed): Other religion: Zoroastrian,4043,60,4103
TS031,31060,Religion (detailed): Religion not stated,3400604,195033,3595637
TS037,37001,General health: Total: All usual residents,56490069,3107388,59597457
TS037,37002,General health: Very good health,27390641,1436483,28827124
TS037,37003,General health: Good health,19040729,1005369,20046098
TS037,37004,General health: Fair health,7147131,449665,7596796
TS037,37005,General health: Bad health,2248089,164067,2412156
TS037,37006,General health: Very bad health,663479,51804,715283
TS038,38001,Disability: Total: All usual residents,56490014,3107456,59597470
TS038,38002,Disability: Disabled under the Equality Act,9774370,670296,10444666
TS038,38003,Disability: Disabled under the Equality Act: Day-to-day activities limited a lot,4140492,319490,4459982
TS038,38004,Disability: Disabled under the Equality Act: Day-to-day activities limited a little,5633878,350806,5984684
TS038,38005,Disability: Not disabled under the Equality Act,46715644,2437160,49152804
TS038,38006,Disability: Not disabled under the Equality Act: Has long term physical or mental health condition but day-to-day activities are not limited,3855968,206467,4062435
TS038,38007,Disability: Not disabled under the Equality Act: No long term physical or mental health conditions,42859676,2230693,45090369
TS039,39001,Provision of unpaid care: Total: All usual residents,53413338,2952700,56366038
TS039,39002,Provision of unpaid care: Provides no unpaid care,48734570,2641623,51376193
TS039,39003,Provision of unpaid care: Provides 19 hours or less unpaid care a week,2304061,138519,2442580
TS039,39004,Provision of unpaid care: Provides 9 hours or less unpaid care a week,1668883,95660,1764543
TS039,39005,Provision of unpaid care: Provides 10 to 19 hours unpaid care a week,635178,42859,678037
TS039,39006,Provision of unpaid care: Provides 20 to 49 hours unpaid care a week,969809,65663,1035472
TS039,39007,Provision of unpaid care: Provides 20 to 34 hours unpaid care a week,452339,31100,483439
TS039,39008,Provision of unpaid care: Provides 35 to 49 hours unpaid care a week,517470,34563,552033
TS039,39009,Provision of unpaid care: Provides 50 or more hours unpaid care a week,1404898,106895,1511793
TS040,40001,Number of disabled people in household: Total: All households,23436693,1347133,24783826
TS040,40002,Number of disabled people in household: No people disabled under the Equality Act in household,15928465,836513,16764978
TS040,40003,Number of disabled people in household: 1 person disabled under the Equality Act in household,5950378,396878,6347256
TS040,40004,Number of disabled people in household: 2 or more people disabled under the Equality Act in household,1557850,113742,1671592
TS041,41001,Number of households: Number of households; measures: Value,23436184,1347120,24783304
TS044,44001,Accommodation type: Total: All households,23435714,1347071,24782785
TS044,44002,Accommodation type: Detached,5368536,384408,5752944
TS044,44003,Accommodation type: Semi-detached,7378111,431840,7809951
TS044,44004,Accommodation type: Terraced,5381563,357991,5739554
TS044,44005,Accommodation type: In a purpose-built block of flats or tenement,3999693,126646,4126339
TS044,44006,"Accommodation type: Part of a converted or shared house, including bedsits",821240,24497,845737
TS044,44007,"Accommodation type: Part of another converted building, for example, former school, church or warehouse",188786,6831,195617
TS044,44008,"Accommodation type: In a commercial building, for example, in an office building, hotel or over a shop",197905,10485,208390
TS044,44009,Accommodation type: A caravan or other mobile or temporary structure,99880,4373,104253
TS045,45001,Number of cars or vans: Total: All households,23436193,1347074,24783267
TS045,45002,Number of cars or vans: No cars or vans in household,5516037,261847,5777884
TS045,45003,Number of cars or vans: 1 car or van in household,9674895,562210,10237105
TS045,45004,Number of cars or vans: 2 cars or vans in household,6107003,378798,6485801
TS045,45005,Number of cars or vans: 3 or more cars or vans in household,2138258,144219,2282477
TS046,46001,Type of central heating in household: Total: All households,23436615,1347096,24783711
TS046,46002,Type of central heating in household: No central heating,351471,15461,366932
TS046,46003,Type of central heating in household: Mains gas only,17334235,964688,18298923
TS046,46004,Type of central heating in household: Tank or bottled gas only,232609,27535,260144
TS046,46005,Type of central heating in household: Electric only,2042218,71146,2113364
TS046,46006,Type of central heating in household: Oil only,760415,105463,865878
TS046,46007,Type of central heating in household: Wood only,31026,4698,35724
TS046,46008,Type of central heating in household: Solid fuel only,42043,7528,49571
TS046,46009,Type of central heating in household: Renewable energy only,92482,6350,98832
TS046,46010,Type of central heating in household: District or communal heat networks only,216429,4352,220781
TS046,46011,Type of central heating in household: Other central heating only,217529,7841,225370
TS046,46012,Type of central heating in household: Two or more types of central heating (not including renewable energy),1989494,124077,2113571
TS046,46013,Type of central heating in household: Two or more types of central heating (including renewable energy),126664,7957,134621
TS047,47001,Position in communal establishment and sex and age: Total: All usual residents in communal establishments,985633,55986,1041619
TS047,47002,Position in communal establishment and sex and age: Resident,946945,53595,1000540
TS047,47003,Position in communal establishment and sex and age: Resident:Male,462800,26319,489119
TS047,47004,Position in communal establishment and sex and age: Resident: Male: Aged 0 to 15 years,18301,489,18790
TS047,47005,Position in communal establishment and sex and age: Resident: Male: Aged 16 to 24 years,217392,12243,229635
TS047,47006,Position in communal establishment and sex and age: Resident: Male: Aged 25 to 34 years,59094,3480,62574
TS047,47007,Position in communal establishment and sex and age: Resident: Male: Aged 35 to 49 years,43540,2669,46209
TS047,47008,Position in communal establishment and sex and age: Resident: Male: Aged 50 to 64 years,35366,1934,37300
TS047,47009,Position in communal establishment and sex and age: Resident: Male: Aged 65 to 74 years,23473,1558,25031
TS047,47010,Position in communal establishment and sex and age: Resident: Male: Aged 75 to 84 years,31720,2003,33723
TS047,47011,Position in communal establishment and sex and age: Resident: Male: Aged 85 years and over,33914,1943,35857
TS047,47012,Position in communal establishment and sex and age: Resident:Female,484145,27276,511421
TS047,47013,Position in communal establishment and sex and age: Resident: Female: Aged 0 to 15 years,14499,300,14799
TS047,47014,Position in communal establishment and sex and age: Resident: Female: Aged 16 to 24 years,221294,12255,233549
TS047,47015,Position in communal establishment and sex and age: Resident: Female: Aged 25 to 34 years,23304,1160,24464
TS047,47016,Position in communal establishment and sex and age: Resident: Female: Aged 35 to 49 years,13986,725,14711
TS047,47017,Position in communal establishment and sex and age: Resident: Female: Aged 50 to 64 years,19159,1058,20217
TS047,47018,Position in communal establishment and sex and age: Resident: Female: Aged 65 to 74 years,19596,1292,20888
TS047,47019,Position in communal establishment and sex and age: Resident: Female: Aged 75 to 84 years,51939,3332,55271
TS047,47020,Position in communal establishment and sex and age: Resident: Female: Aged 85 years and over,120368,7154,127522
TS047,47021,Position in communal establishment and sex and age: Staff or owner,13098,820,13918
TS047,47022,Position in communal establishment and sex and age: Family member or partner of staff or owner,4432,214,4646
TS047,47023,Position in communal establishment and sex and age: Staying temporarily (no usual UK address),21158,1357,22515
TS048,48001,Communal establishment management and type: Total: All usual residents in communal establishments,985841,55924,1041765
TS048,48002,Communal establishment management and type: Medical and care establishment,346423,21675,368098
TS048,48003,Communal establishment management and type: Medical and care establishment:NHS,7175,482,7657
TS048,48004,Communal establishment management and type: Medical and care establishment: NHS: General hospital,958,233,1191
TS048,48005,Communal establishment management and type: Medical and care establishment: NHS: Mental health hospital or unit (including secure units),5469,167,5636
TS048,48006,Communal establishment management and type: Medical and care establishment: NHS: Other hospital,748,82,830
TS048,48007,Communal establishment management and type: Medical and care establishment:Local Authority,11223,1725,12948
TS048,48008,Communal establishment management and type: Medical and care establishment: Local Authority: Children's home (including secure units),271,57,328
TS048,48009,Communal establishment management and type: Medical and care establishment: Local Authority: Care home with nursing,2772,141,2913
TS048,48010,Communal establishment management and type: Medical and care establishment: Local Authority: Care home without nursing,7975,1486,9461
TS048,48011,Communal establishment management and type: Medical and care establishment: Local Authority: Other home,205,41,246
TS048,48012,Communal establishment management and type: Medical and care establishment:Registered Social Landlord or Housing Association,2778,442,3220
TS048,48013,Communal establishment management and type: Medical and care establishment: Registered Social Landlord or Housing Association: Home or hostel,2778,442,3220
TS048,48014,Communal establishment management and type: Medical and care establishment:Other,325247,19026,344273
TS048,48015,Communal establishment management and type: Medical and care establishment: Other: Care home with nursing,148771,8739,157510
TS048,48016,Communal establishment management and type: Medical and care establishment: Other: Care home without nursing,164933,9242,174175
TS048,48017,Communal establishment management and type: Medical and care establishment: Other: Children's home (including secure units),2800,474,3274
TS048,48018,Communal establishment management and type: Medical and care establishment: Other: Mental health hospital or unit (including secure units),5166,471,5637
TS048,48019,Communal establishment management and type: Medical and care establishment: Other: Other hospital,669,5,674
TS048,48020,Communal establishment management and type: Medical and care establishment: Other: Other establishment,2908,95,3003
TS048,48021,Communal establishment management and type: Other establishment,612253,33010,645263
TS048,48022,Communal establishment management and type: Other establishment: Defence,41118,979,42097
TS048,48023,Communal establishment management and type: Other establishment: Prison service,61326,4003,65329
TS048,48024,Communal establishment management and type: Other establishment: Approved premises (probation or bail hostel),1367,153,1520
TS048,48025,Communal establishment management and type: Other establishment: Detention centres and other detention,348,0,348
TS048,48026,Communal establishment management and type: Other establishment: Education,452144,24415,476559
TS048,48027,"Communal establishment management and type: Other establishment: Hotel, guest house, B&B or youth hostel",13899,1144,15043
TS048,48028,Communal establishment management and type: Other establishment: Hostel or temporary shelter for the homeless,13109,1034,14143
TS048,48029,Communal establishment management and type: Other establishment: Holiday accommodation,1371,63,1434
TS048,48030,Communal establishment management and type: Other establishment: Other travel or temporary accommodation,1240,47,1287
TS048,48031,Communal establishment management and type: Other establishment: Religious,3530,137,3667
TS048,48032,Communal establishment management and type: Other establishment: Staff or worker accommodation or Other,22801,1035,23836
TS048,48033,Communal establishment management and type: Establishment not stated,27165,1239,28404
TS050,50001,Number of bedrooms: Total: All households,23435982,1347216,24783198
TS050,50002,Number of bedrooms: 1 bedroom,2722971,102915,2825886
TS050,50003,Number of bedrooms: 2 bedrooms,6394740,320974,6715714
TS050,50004,Number of bedrooms: 3 bedrooms,9373574,646295,10019869
TS050,50005,Number of bedrooms: 4 or more bedrooms,4944697,277032,5221729
TS051,51001,Number of rooms (VOA): Total: All households,23436625,1346907,24783532
TS051,51002,Number of rooms (VOA): 1 room,256150,4129,260279
TS051,51003,Number of rooms (VOA): 2 rooms,2350963,84622,2435585
TS051,51004,Number of rooms (VOA): 3 rooms,5469129,247873,5717002
TS051,51005,Number of rooms (VOA): 4 rooms,6516207,380897,6897104
TS051,51006,Number of rooms (VOA): 5 rooms,5351735,391244,5742979
TS051,51007,Number of rooms (VOA): 6 rooms,2013273,151651,2164924
TS051,51008,Number of rooms (VOA): 7 rooms,866016,54461,920477
TS051,51009,Number of rooms (VOA): 8 rooms,348137,18985,367122
TS051,51010,Number of rooms (VOA): 9 or more rooms,265015,13045,278060
TS052,52001,Occupancy rating for bedrooms: Total: All households,23435845,1347056,24782901
TS052,52002,Occupancy rating for bedrooms: Occupancy rating of bedrooms: +2 or more,8341161,561167,8902328
TS052,52003,Occupancy rating for bedrooms: Occupancy rating of bedrooms: +1,7791363,467165,8258528
TS052,52004,Occupancy rating for bedrooms: Occupancy rating of bedrooms: 0,6278353,288936,6567289
TS052,52005,Occupancy rating for bedrooms: Occupancy rating of bedrooms: -1,854348,26305,880653
TS052,52006,Occupancy rating for bedrooms: Occupancy rating of bedrooms: -2 or less,170620,3483,174103
TS053,53001,Occupancy rating for rooms: Total: All households,23436803,1347011,24783814
TS053,53002,Occupancy rating for rooms: Occupancy rating of rooms: +2 or more,10602767,751188,11353955
TS053,53003,Occupancy rating for rooms: Occupancy rating of rooms: +1,6273346,344413,6617759
TS053,53004,Occupancy rating for rooms: Occupancy rating of rooms: 0,5050246,209847,5260093
TS053,53005,Occupancy rating for rooms: Occupancy rating of rooms: -1,1246054,36121,1282175
TS053,53006,Occupancy rating for rooms: Occupancy rating of rooms: -2 or less,264390,5442,269832
TS054,54001,Tenure of household: Total: All households,23435688,1347195,24782883
TS054,54002,Tenure of household: Owned,14369003,889948,15258951
TS054,54003,Tenure of household: Owned: Owns outright,7624618,512102,8136720
TS054,54004,Tenure of household: Owned: Owns with a mortgage or loan,6744385,377846,7122231
TS054,54005,Tenure of household: Shared ownership,235874,4278,240152
TS054,54006,Tenure of household: Shared ownership: Shared ownership,235874,4278,240152
TS054,54007,Tenure of household: Social rented,4005807,222062,4227869
TS054,54008,Tenure of household: Social rented: Rents from council or Local Authority,1945230,116623,2061853
TS054,54009,Tenure of household: Social rented: Other social rented,2060577,105439,2166016
TS054,54010,Tenure of household: Private rented,4794520,228717,5023237
TS054,54011,Tenure of household: Private rented: Private landlord or letting agency,4273408,194905,4468313
TS054,54012,Tenure of household: Private rented: Other private rented,521112,33812,554924
TS054,54013,Tenure of household: Lives rent free,30484,2190,32674
TS055,55001,Second address type: Total: All usual residents,3026889,161052,3187941
TS055,55002,Second address type: Armed forces base address,30984,2355,33339
TS055,55003,Second address type: Another address when working away from home,177220,11060,188280
TS055,55004,Second address type: Holiday home,428915,17585,446500
TS055,55005,Second address type: Student's term-time address,14004,1778,15782
TS055,55006,Second address type: Student's home address,618115,37345,655460
TS055,55007,Second address type: Another parent or guardian's address,998409,58082,1056491
TS055,55008,Second address type: Partner's address,280664,12849,293513
TS055,55009,Second address type: Other,478578,19998,498576
TS055,55010,Second address type: Second address type not specified,0,0,0
TS056,56001,Second address indicator: Total: All usual residents,56490789,3107543,59598332
TS056,56002,Second address indicator: No second address,53463596,2946366,56409962
TS056,56003,Second address indicator: Second address is in the UK,2311297,140651,2451948
TS056,56004,Second address indicator: Second address is outside the UK,715896,20526,736422
TS058,58001,Distance travelled to work: Total: All usual residents aged 16 years and over in employment the week before the census,26404041,1368528,27772569
TS058,58002,Distance travelled to work: Less than 2km,2899167,158964,3058131
TS058,58003,Distance travelled to work: 2km to less than 5km,3335913,163322,3499235
TS058,58004,Distance travelled to work: 5km to less than 10km,3099303,174567,3273870
TS058,58005,Distance travelled to work: 10km to less than 20km,2749856,174237,2924093
TS058,58006,Distance travelled to work: 20km to less than 30km,1052006,75424,1127430
TS058,58007,Distance travelled to work: 30km to less than 40km,439035,31144,470179
TS058,58008,Distance travelled to work: 40km to less than 60km,336313,22315,358628
TS058,58009,Distance travelled to work: 60km and over,354574,27535,382109
TS058,58010,Distance travelled to work: Works mainly from home,8321334,350501,8671835
TS058,58011,"Distance travelled to work: Works mainly at an offshore installation, in no fixed place, or outside the UK",3816540,190519,4007059
TS059,59001,Hours worked: Total: All usual residents aged 16 years and over in employment the week before the census,26405010,1368538,27773548
TS059,59002,Hours worked: Part-time,7871056,409638,8280694
TS059,59003,Hours worked: Part-time: 15 hours or less worked,2731044,123674,2854718
TS059,59004,Hours worked: Part-time: 16 to 30 hours worked,5140012,285964,5425976
TS059,59005,Hours worked: Full-time,18533954,958900,19492854
TS059,59006,Hours worked: Full-time: 31 to 48 hours worked,15609016,818770,16427786
TS059,59007,Hours worked: Full-time: 49 or more hours worked,2924938,140130,3065068
TS060,60001,Industry (current): Total: All usual residents aged 16 years and over in employment the week before the census,26405401,1368270,27773671
TS060,60002,"Industry (current): A: Agriculture, Forestry and fishing",211831,25188,237019
TS060,60003,"Industry (current): 01 Crop and animal production, hunting and related service activities",199926,23795,223721
TS060,60004,Industry (current): 02 Forestry and logging,6345,989,7334
TS060,60005,Industry (current): 03 Fishing and aquaculture,5560,404,5964
TS060,60006,Industry (current): B: Mining and quarrying,40202,2554,42756
TS060,60007,Industry (current): 05 Mining of coal and lignite,1496,475,1971
TS060,60008,Industry (current): 06 Extraction of crude petroleum and natural gas,24867,957,25824
TS060,60009,Industry (current): 07 Mining of metal ores,518,12,530
TS060,60010,Industry (current): 08 Other mining and quarrying,10907,961,11868
TS060,60011,Industry (current): 09 Mining support service activities,2414,149,2563
TS060,60012,Industry (current): C: Manufacturing,1921766,118773,2040539
TS060,60013,Industry (current): 10 Manufacture of food products,276880,18088,294968
TS060,60014,Industry (current): 11 Manufacture of beverages,37571,1824,39395
TS060,60015,Industry (current): 12 Manufacture of tobacco products,3522,58,3580
TS060,60016,Industry (current): 13 Manufacture of textiles,41713,1644,43357
TS060,60017,Industry (current): 14 Manufacture of wearing apparel,48623,1342,49965
TS060,60018,Industry (current): 15 Manufacture of leather and related products,8544,217,8761
TS060,60019,"Industry (current): 16 Manufacture of wood and of products of wood and cork, except furniture; manufacture of articles of straw and plaiting materials",18920,1744,20664
TS060,60020,Industry (current): 17 Manufacture of paper and paper products,23808,2066,25874
TS060,60021,Industry (current): 18 Printing and reproduction of recorded media,85817,3251,89068
TS060,60022,Industry (current): 19 Manufacture of coke and refined petroleum products,10145,1303,11448
TS060,60023,Industry (current): 20 Manufacture of chemicals and chemical products,59332,3529,62861
TS060,60024,Industry (current): 21 Manufacture of basic pharmaceutical products and pharmaceutical preparations,95446,4310,99756
TS060,60025,Industry (current): 22 Manufacture of rubber and plastic products,90358,6017,96375
TS060,60026,Industry (current): 23 Manufacture of other non-metallic mineral products,44077,2847,46924
TS060,60027,Industry (current): 24 Manufacture of basic metals,55146,10860,66006
TS060,60028,"Industry (current): 25 Manufacture of fabricated metal products, except machinery and equipment",136670,7254,143924
TS060,60029,"Industry (current): 26 Manufacture of computer, electrical and optical products",86948,4960,91908
TS060,60030,Industry (current): 27 Manufacture of electrical equipment,40270,2748,43018
TS060,60031,Industry (current): 28 Manufacture of machinery and equipment not otherwise specified,87758,3138,90896
TS060,60032,"Industry (current): 29 Manufacture of motor vehicles, trailers and semi-trailers",181663,8660,190323
TS060,60033,Industry (current): 30 Manufacture of other transport equipment,103153,6983,110136
TS060,60034,Industry (current): 31 Manufacture of furniture,69208,3666,72874
TS060,60035,Industry (current): 32 Other Manufacturing,274817,19016,293833
TS060,60036,Industry (current): 33 Repair and installation of machinery and equipment,41377,3248,44625
TS060,60037,"Industry (current): D: Electricity, gas, steam and air conditioning supply",152063,9467,161530
TS060,60038,"Industry (current): 35 Electricity, gas, steam and air conditioning supply",152063,9467,161530
TS060,60039,"Industry (current): E:  Water supply; Sewerage, Waste management and Remediation activities",190199,13415,203614
TS060,60040,"Industry (current): 36 Water collection, treatment and supply",70786,5782,76568
TS060,60041,Industry (current): 37 Sewerage,11867,526,12393
TS060,60042,"Industry (current): 38 Waste collection, treatment and disposal activities; materials recovery",102486,6684,109170
TS060,60043,Industry (current): 39 Remediation activities and other waste management services,5060,423,5483
TS060,60044,Industry (current): F: Construction,2288520,117662,2406182
TS060,60045,Industry (current): 41 Construction of buildings; 42 Civil engineering; 43 Specialised construction activities,2288520,117662,2406182
TS060,60046,Industry (current): G: Wholesale and retail trade; repair of motor vehicles and motorcycles,3958281,198055,4156336
TS060,60047,Industry (current): 45 Wholesale and retail trade and repair of motor vehicles and motorcycles,415971,22899,438870
TS060,60048,"Industry (current): 46 Wholesale trade, except of motor vehicles and motorcycles",735181,34301,769482
TS060,60049,"Industry (current): 47 Retail trade, except of motor vehicles and motorcycles",2707368,137124,2844492
TS060,60050,Industry (current): 48 Wholesale and retail not otherwise specified,99761,3731,103492
TS060,60051,Industry (current): H: Transport and storage,1328902,52598,1381500
TS060,60052,Industry (current): 49 Land transport and transport via pipelines,668489,28641,697130
TS060,60053,Industry (current): 50 Water transport,26779,1246,28025
TS060,60054,Industry (current): 51 Air transport,57838,1496,59334
TS060,60055,Industry (current): 52 Warehousing and support activities for transportation,280879,7751,288630
TS060,60056,Industry (current): 53 Postal and courier activities,294917,13464,308381
TS060,60057,Industry (current): I: Accommodation and food service activities,1291567,71396,1362963
TS060,60058,Industry (current): 55 Accommodation,197694,15041,212735
TS060,60059,Industry (current): 56 Food and beverage service activities,1093873,56355,1150228
TS060,60060,Industry (current): J: Information and communication,1246619,37458,1284077
TS060,60061,Industry (current): 58 Publishing activities,81733,1631,83364
TS060,60062,"Industry (current): 59 Motion picture, video and television production, sound recording and music publishing activities",111753,4095,115848
TS060,60063,Industry (current): 60 Programming and broadcasting activities,52716,2619,55335
TS060,60064,Industry (current): 61 Telecommunications,198030,8881,206911
TS060,60065,"Industry (current): 62 Computer programming, consultancy and related activities",770897,19392,790289
TS060,60066,Industry (current): 63 Information service activities,31490,840,32330
TS060,60067,Industry (current): K: Financial and insurance activities,1007558,39206,1046764
TS060,60068,"Industry (current): 64 Financial service activities, except insurance and pension funding",466390,17027,483417
TS060,60069,"Industry (current): 65 Insurance, reinsurance and pension funding, except compulsory social security",252513,13974,266487
TS060,60070,Industry (current): 66 Activities auxiliary to financial services and insurance activities,288655,8205,296860
TS060,60071,Industry (current): L: Real estate activities,412714,17841,430555
TS060,60072,Industry (current): 68 Real estate activities,412714,17841,430555
TS060,60073,"Industry (current): M: Professional, scientific and technical activities",1768418,60369,1828787
TS060,60074,Industry (current): 69 Legal and accounting activities,587585,21913,609498
TS060,60075,Industry (current): 70 Activities of head offices; management consultancy activities,242601,6566,249167
TS060,60076,Industry (current): 71 Architectural and engineering activities; technical testing and analysis,356609,14922,371531
TS060,60077,Industry (current): 72 Scientific research and development,127988,3883,131871
TS060,60078,Industry (current): 73 Advertising and market research,229257,3807,233064
TS060,60079,"Industry (current): 74 Other professional, scientific and technical activities",160352,5484,165836
TS060,60080,Industry (current): 75 Veterinary activities,64026,3794,67820
TS060,60081,Industry (current): N: Administrative and support service activities,1398928,58027,1456955
TS060,60082,Industry (current): 77 Rental and leasing activities,79812,4054,83866
TS060,60083,Industry (current): 78 Employment activities,184167,6093,190260
TS060,60084,"Industry (current): 79 Travel agency, tour operator and other reservation service and related activities",97340,4589,101929
TS060,60085,Industry (current): 80 Security and investigation activities,158199,6462,164661
TS060,60086,Industry (current): 81 Services to buildings and landscape activities,679694,28046,707740
TS060,60087,"Industry (current): 82 Office administrative, office support and other business support activities",199716,8783,208499
TS060,60088,Industry (current): O: Public administration and defence; compulsory social security,1521248,125410,1646658
TS060,60089,Industry (current): 84 Public administration and defence; compulsory social security,1521248,125410,1646658
TS060,60090,Industry (current): P: Education,2601702,131147,2732849
TS060,60091,Industry (current): 85 Education,2601702,131147,2732849
TS060,60092,Industry (current): Q: Human health and social work activities,3856647,232737,4089384
TS060,60093,Industry (current): 86 Human health activities,2343791,137662,2481453
TS060,60094,Industry (current): 87 Residential care activities,405677,25158,430835
TS060,60095,Industry (current): 88 Social work activities without accommodation,1107179,69917,1177096
TS060,60096,"Industry (current): R, S, T, U Other",1208236,56967,1265203
TS060,60097,"Industry (current): 90 Creative, arts and entertainment activities",242158,9599,251757
TS060,60098,"Industry (current): 91 Libraries, archives, museums and other cultural activities",67119,3507,70626
TS060,60099,Industry (current): 92 Gambling and betting activities,54732,1967,56699
TS060,60100,Industry (current): 93 Sports activities and amusement and recreation activities,255215,13029,268244
TS060,60101,Industry (current): 94 Activities of membership organisations,142492,6898,149390
TS060,60102,Industry (current): 95 Repair of computers and personal and household goods,25550,1179,26729
TS060,60103,Industry (current): 96 Other personal service activities,395658,20466,416124
TS060,60104,Industry (current): 97 Activities of households as employers of domestic personnel,14031,232,14263
TS060,60105,Industry (current): 98 Undifferentiated goods- and services-producing activities of private households for own use,8,0,8
TS060,60106,Industry (current): 99 Activities of extraterritorial organisations and bodies,11273,90,11363
TS061,61001,Method of travel to workplace: Total: All usual residents aged 16 years and over in employment the week before the census,26405475,1368284,27773759
TS061,61002,Method of travel to workplace: Work mainly at or from home,8321334,350501,8671835
TS061,61003,"Method of travel to workplace: Underground, metro, light rail, tram",504683,584,505267
TS061,61004,Method of travel to workplace: Train,517336,11554,528890
TS061,61005,"Method of travel to workplace: Bus, minibus or coach",1129655,31431,1161086
TS061,61006,Method of travel to workplace: Taxi,192690,7591,200281
TS061,61007,"Method of travel to workplace: Motorcycle, scooter or moped",124068,4634,128702
TS061,61008,Method of travel to workplace: Driving a car or van,11752034,772629,12524663
TS061,61009,Method of travel to workplace: Passenger in a car or van,1017659,65938,1083597
TS061,61010,Method of travel to workplace: Bicycle,554059,15049,569108
TS061,61011,Method of travel to workplace: On foot,2017642,96711,2114353
TS061,61012,Method of travel to workplace: Other method of travel to work,274315,11662,285977
TS062,62001,National Statistics Socio-economic Classification (NS-SEC): Total: All usual residents aged 16 years and over,46005691,2559359,48565050
TS062,62002,"National Statistics Socio-economic Classification (NS-SEC): L1, L2 and L3 Higher managerial, administrative and professional occupations",6092904,261042,6353946
TS062,62003,"National Statistics Socio-economic Classification (NS-SEC): L4, L5 and L6 Lower managerial, administrative and professional occupations",9172007,497448,9669455
TS062,62004,National Statistics Socio-economic Classification (NS-SEC): L7 Intermediate occupations,5255237,296131,5551368
TS062,62005,National Statistics Socio-economic Classification (NS-SEC): L8 and L9 Small employers and own account workers,4873103,258122,5131225
TS062,62006,National Statistics Socio-economic Classification (NS-SEC): L10 and L11 Lower supervisory and technical occupations,2460762,159907,2620669
TS062,62007,National Statistics Socio-economic Classification (NS-SEC): L12 Semi-routine occupations,5183606,335204,5518810
TS062,62008,National Statistics Socio-economic Classification (NS-SEC): L13 Routine occupations,5522188,337651,5859839
TS062,62009,National Statistics Socio-economic Classification (NS-SEC): L14.1 and L14.2 Never worked and long-term unemployed,3915159,218463,4133622
TS062,62010,National Statistics Socio-economic Classification (NS-SEC): L15 Full-time students,3530725,195391,3726116
TS063,63001,Occupation (current): Total: All usual residents aged 16 years and over in employment the week before the census,26405386,1368411,27773797
TS063,63002,"Occupation (current): 1. Managers, directors and senior officials",3403933,143866,3547799
TS063,63003,Occupation (current): 2. Professional occupations,5356785,249531,5606316
TS063,63004,Occupation (current): 3. Associate professional and technical occupations,3499815,161275,3661090
TS063,63005,Occupation (current): 4. Administrative and secretarial occupations,2446818,128038,2574856
TS063,63006,Occupation (current): 5. Skilled trades occupations,2682626,166629,2849255
TS063,63007,"Occupation (current): 6. Caring, leisure and other service occupations",2447400,152994,2600394
TS063,63008,Occupation (current): 7. Sales and customer service occupations,1972870,114577,2087447
TS063,63009,"Occupation (current): 8. Process, plant and machine operatives",1832369,107455,1939824
TS063,63010,Occupation (current): 9. Elementary occupations,2762770,144046,2906816
TS064,64001,Occupation (current): Total: All usual residents aged 16 years and over in employment the week before the census,26404125,1368408,27772533
TS064,64002,Occupation (current): 111 Chief Executives and Senior Officials,125908,3447,129355
TS064,64003,Occupation (current): 112 Production Managers and Directors,573715,26904,600619
TS064,64004,Occupation (current): 113 Functional Managers and Directors,953367,29400,982767
TS064,64005,"Occupation (current): 114 Directors in Logistics, Warehousing and Transport",14451,568,15019
TS064,64006,Occupation (current): 115 Managers and Directors in Retail and Wholesale,442374,20559,462933
TS064,64007,Occupation (current): 116 Senior Officers in Protective Services,42211,2035,44246
TS064,64008,Occupation (current): 117 Health and Social Services Managers and Directors,114738,6424,121162
TS064,64009,Occupation (current): 121 Managers and Proprietors in Agriculture Related Services,48705,3098,51803
TS064,64010,Occupation (current): 122 Managers and Proprietors in Hospitality and Leisure Services,284500,17035,301535
TS064,64011,Occupation (current): 123 Managers and Proprietors in Health and Care Services,78279,4576,82855
TS064,64012,"Occupation (current): 124 Managers in Logistics, Warehousing and Transport",162441,7506,169947
TS064,64013,Occupation (current): 125 Managers and Proprietors in Other Services,563129,22381,585510
TS064,64014,Occupation (current): 211 Natural and Social Science Professionals,92736,4945,97681
TS064,64015,Occupation (current): 212 Engineering Professionals,364694,18315,383009
TS064,64016,Occupation (current): 213 Information Technology Professionals,669528,21116,690644
TS064,64017,Occupation (current): 214 Web and Multimedia Design Professionals,93043,2950,95993
TS064,64018,Occupation (current): 215 Conservation and Environment Professionals,36235,2682,38917
TS064,64019,Occupation (current): 216 Research and Development (R&D) and Other Research Professionals,82090,3059,85149
TS064,64020,Occupation (current): 221 Medical Practitioners,226514,11288,237802
TS064,64021,Occupation (current): 222 Therapy Professionals,162047,7915,169962
TS064,64022,Occupation (current): 223 Nursing and Midwifery Professionals,583308,37952,621260
TS064,64023,Occupation (current): 224 Veterinarians,18239,1323,19562
TS064,64024,Occupation (current): 225 Other Health Professionals,197212,11506,208718
TS064,64025,Occupation (current): 231 Teaching and other Educational Professionals,914047,47920,961967
TS064,64026,Occupation (current): 232 Other Educational Professionals,193493,9400,202893
TS064,64027,Occupation (current): 241 Legal Professionals,216777,8410,225187
TS064,64028,Occupation (current): 242 Finance Professionals,371720,13339,385059
TS064,64029,"Occupation (current): 243 Business, Research and Administrative Professionals",331859,11255,343114
TS064,64030,Occupation (current): 244 Business and Financial Project Management Professionals,194077,7780,201857
TS064,64031,"Occupation (current): 245 Architects, Chartered Architectural Technologists, Planning Officers, Surveyors and Construction Professionals",180209,8012,188221
TS064,64032,Occupation (current): 246 Welfare Professionals,142617,9782,152399
TS064,64033,Occupation (current): 247 Librarians and Related Professionals,18496,1010,19506
TS064,64034,Occupation (current): 248 Quality and Regulatory Professionals,125025,6059,131084
TS064,64035,Occupation (current): 249 Media Professionals,142186,3503,145689
TS064,64036,"Occupation (current): 311 Science, Engineering and Production Technicians",231788,14447,246235
TS064,64037,"Occupation (current): 312 CAD, Drawing and Architectural Technicians",55274,2169,57443
TS064,64038,Occupation (current): 313 Information Technology Technicians,203760,8341,212101
TS064,64039,Occupation (current): 321 Health Associate Professionals,101382,5597,106979
TS064,64040,Occupation (current): 322 Welfare and Housing Associate Professionals,231435,15704,247139
TS064,64041,Occupation (current): 323 Teaching and Childcare Associate Professionals,197944,6807,204751
TS064,64042,Occupation (current): 324 Veterinary nurses,17839,894,18733
TS064,64043,Occupation (current): 331 Protective Service Occupations,334450,17961,352411
TS064,64044,"Occupation (current): 341 Artistic, Literary and Media Occupations",329413,13391,342804
TS064,64045,Occupation (current): 342 Design Occupations,68226,2041,70267
TS064,64046,Occupation (current): 343 Sports and Fitness Occupations,133955,6094,140049
TS064,64047,Occupation (current): 351 Transport Associate Professionals,25939,1156,27095
TS064,64048,Occupation (current): 352 Legal Associate Professionals,41586,2361,43947
TS064,64049,Occupation (current): 353 Finance Associate Professionals,182803,6526,189329
TS064,64050,Occupation (current): 354 Business Associate Professionals,252592,12246,264838
TS064,64051,"Occupation (current): 355 Sales, Marketing and Related Associate Professionals",703800,23955,727755
TS064,64052,Occupation (current): 356 Public Services Associate Professionals,39783,2730,42513
TS064,64053,"Occupation (current): 357 HR, Training and Other Vocational Associate Guidance Professionals",280478,14055,294533
TS064,64054,Occupation (current): 358 Regulatory Associate Professionals,66878,4740,71618
TS064,64055,Occupation (current): 411 Administrative Occupations: Government and Related Organisations,254466,21287,275753
TS064,64056,Occupation (current): 412 Administrative Occupations: Finance,480042,22204,502246
TS064,64057,Occupation (current): 413 Administrative Occupations: Records,318150,16199,334349
TS064,64058,Occupation (current): 414 Administrative Occupations: Office Managers and Supervisors,221820,10669,232489
TS064,64059,Occupation (current): 415 Other Administrative Occupations,633732,31915,665647
TS064,64060,Occupation (current): 421 Secretarial and Related Occupations,538260,25802,564062
TS064,64061,Occupation (current): 511 Agricultural and Related Trades,271027,26230,297257
TS064,64062,"Occupation (current): 521 Metal Forming, Welding and Related Trades",123940,7851,131791
TS064,64063,"Occupation (current): 522 Metal Machining, Fitting and Instrument Making Trades",193152,11950,205102
TS064,64064,Occupation (current): 523 Vehicle Trades,207420,13055,220475
TS064,64065,Occupation (current): 524 Electrical and Electronic Trades,333670,19064,352734
TS064,64066,"Occupation (current): 525 Skilled Metal, Electrical and Electronic Trades Supervisors",35994,2245,38239
TS064,64067,Occupation (current): 531 Construction and Building Trades,726100,42121,768221
TS064,64068,Occupation (current): 532 Building Finishing Trades,215573,11928,227501
TS064,64069,Occupation (current): 533 Construction and Building Trades Supervisors,52574,3273,55847
TS064,64070,Occupation (current): 541 Textiles and Garments Trades,37515,1765,39280
TS064,64071,Occupation (current): 542 Printing Trades,27733,1072,28805
TS064,64072,Occupation (current): 543 Food Preparation and Hospitality Trades,391696,22366,414062
TS064,64073,Occupation (current): 544 Other Skilled Trades,66696,3698,70394
TS064,64074,Occupation (current): 611 Teaching and Childcare Support Occupations,511422,31616,543038
TS064,64075,Occupation (current): 612 Animal Care and Control Services,76850,3808,80658
TS064,64076,Occupation (current): 613 Caring Personal Services,1299511,88328,1387839
TS064,64077,Occupation (current): 621 Leisure and Travel Services,108363,5031,113394
TS064,64078,Occupation (current): 622 Hairdressers and Related Services,233084,12740,245824
TS064,64079,Occupation (current): 623 Housekeeping and Related Services,135836,6363,142199
TS064,64080,Occupation (current): 624 Cleaning and Housekeeping Managers and Supervisors,54951,2651,57602
TS064,64081,Occupation (current): 625 Bed and Breakfast and Guest House Owners and Proprietors,6553,802,7355
TS064,64082,Occupation (current): 631 Community and Civil Enforcement Occupations,20621,1692,22313
TS064,64083,Occupation (current): 711 Sales Assistants and Retail Cashiers,1243924,72925,1316849
TS064,64084,Occupation (current): 712 Sales Related Occupations,61522,3554,65076
TS064,64085,Occupation (current): 713 Shopkeepers and Sales Supervisors,263749,14846,278595
TS064,64086,Occupation (current): 721 Customer Service Occupations,386163,22439,408602
TS064,64087,Occupation (current): 722 Customer Service Supervisors,17279,807,18086
TS064,64088,Occupation (current): 811 Process Operatives,229398,16683,246081
TS064,64089,Occupation (current): 812 Metal Working Machine Operatives,45063,3198,48261
TS064,64090,Occupation (current): 813 Plant and Machine Operatives,81296,6209,87505
TS064,64091,Occupation (current): 814 Assemblers and Routine Operatives,175096,11535,186631
TS064,64092,Occupation (current): 815 Construction Operatives,163605,10028,173633
TS064,64093,"Occupation (current): 816 Production, Factory and Assembly Supervisors",54704,3543,58247
TS064,64094,Occupation (current): 821 Road Transport Drivers,893213,44592,937805
TS064,64095,Occupation (current): 822 Mobile Machine Drivers and Operatives,120040,8452,128492
TS064,64096,Occupation (current): 823 Other Drivers and Transport Operatives,70137,3249,73386
TS064,64097,Occupation (current): 911 Elementary Agricultural Occupations,52356,4323,56679
TS064,64098,Occupation (current): 912 Elementary Construction Occupations,162760,10264,173024
TS064,64099,Occupation (current): 913 Elementary Process Plant Occupations,213312,15642,228954
TS064,64100,Occupation (current): 921 Elementary Administration Occupations,155929,7908,163837
TS064,64101,Occupation (current): 922 Elementary Cleaning Occupations,681902,35882,717784
TS064,64102,Occupation (current): 923 Elementary Security Occupations,244713,10314,255027
TS064,64103,Occupation (current): 924 Elementary Sales Occupations,75013,3749,78762
TS064,64104,Occupation (current): 925 Elementary Storage Occupations,527731,20145,547876
TS064,64105,Occupation (current): 926 Other Elementary Services Occupations,649174,35727,684901
TS065,65001,Unemployment history: Total: All usual residents aged 16 years and over not in employment the week before the census,19601329,1191051,20792380
TS065,65002,Unemployment history: Not in employment: Worked in the last 12 months,2592525,136875,2729400
TS065,65003,Unemployment history: Not in employment: Not worked in the last 12 months,11983933,779057,12762990
TS065,65004,Unemployment history: Not in employment: Never worked,5024871,275119,5299990
TS066,66001,Economic activity status: Total: All usual residents aged 16 years and over,46008527,2559477,48568004
TS066,66002,Economic activity status: Economically active (excluding full-time students),26946946,1391569,28338515
TS066,66003,Economic activity status: Economically active (excluding full-time students):In employment,25633969,1327951,26961920
TS066,66004,Economic activity status: Economically active (excluding full-time students):In employment:Employee,21243267,1118804,22362071
TS066,66005,Economic activity status: Economically active (excluding full-time students): In employment: Employee: Part-time,5475868,302937,5778805
TS066,66006,Economic activity status: Economically active (excluding full-time students): In employment: Employee: Full-time,15767399,815867,16583266
TS066,66007,Economic activity status: Economically active (excluding full-time students):In employment:Self-employed with employees,703062,37790,740852
TS066,66008,Economic activity status: Economically active (excluding full-time students): In employment: Self-employed with employees: Part-time,168216,7846,176062
TS066,66009,Economic activity status: Economically active (excluding full-time students): In employment: Self-employed with employees: Full-time,534846,29944,564790
TS066,66010,Economic activity status: Economically active (excluding full-time students):In employment:Self-employed without employees,3687640,171357,3858997
TS066,66011,Economic activity status: Economically active (excluding full-time students): In employment: Self-employed without employees: Part-time,1613461,65334,1678795
TS066,66012,Economic activity status: Economically active (excluding full-time students): In employment: Self-employed without employees: Full-time,2074179,106023,2180202
TS066,66013,Economic activity status: Economically active (excluding full-time students): Unemployed,1312977,63618,1376595
TS066,66014,Economic activity status: Economically active and a full-time student,1056128,55987,1112115
TS066,66015,Economic activity status: Economically active and a full-time student:In employment,772565,40701,813266
TS066,66016,Economic activity status: Economically active and a full-time student:In employment:Employee,707950,38228,746178
TS066,66017,Economic activity status: Economically active and a full-time student: In employment: Employee: Part-time,566580,31656,598236
TS066,66018,Economic activity status: Economically active and a full-time student: In employment: Employee: Full-time,141370,6572,147942
TS066,66019,Economic activity status: Economically active and a full-time student:In employment:Self-employed with employees,6866,274,7140
TS066,66020,Economic activity status: Economically active and a full-time student: In employment: Self-employed with employees: Part-time,4085,147,4232
TS066,66021,Economic activity status: Economically active and a full-time student: In employment: Self-employed with employees: Full-time,2781,127,2908
TS066,66022,Economic activity status: Economically active and a full-time student:In employment:Self-employed without employees,57749,2199,59948
TS066,66023,Economic activity status: Economically active and a full-time student: In employment: Self-employed without employees: Part-time,43834,1675,45509
TS066,66024,Economic activity status: Economically active and a full-time student: In employment: Self-employed without employees: Full-time,13915,524,14439
TS066,66025,Economic activity status: Economically active and a full-time student: Unemployed,283563,15286,298849
TS066,66026,Economic activity status: Economically inactive,18005453,1111921,19117374
TS066,66027,Economic activity status: Economically inactive: Retired,9881722,631603,10513325
TS066,66028,Economic activity status: Economically inactive: Student,2595306,145181,2740487
TS066,66029,Economic activity status: Economically inactive: Looking after home or family,2207707,109548,2317255
TS066,66030,Economic activity status: Economically inactive: Long-term sick or disabled,1874653,151334,2025987
TS066,66031,Economic activity status: Economically inactive: Other,1446065,74255,1520320
TS067,67001,Highest level of qualification: Total: All usual residents aged 16 years and over,46007598,2559409,48567007
TS067,67002,Highest level of qualification: No qualifications,8318062,509659,8827721
TS067,67003,Highest level of qualification: Level 1 and entry level qualifications,4456510,223034,4679544
TS067,67004,Highest level of qualification: Level 2 qualifications,6126008,367300,6493308
TS067,67005,Highest level of qualification: Apprenticeship,2447065,143307,2590372
TS067,67006,Highest level of qualification: Level 3 qualifications,7784935,440668,8225603
TS067,67007,Highest level of qualification: Level 4 qualifications and above,15606610,806806,16413416
TS067,67008,Highest level of qualification: Other qualifications,1268408,68635,1337043
TS068,68001,Schoolchild or full-time student indicator: Total: All usual residents aged 5 years and over,53412938,2952352,56365290
TS068,68002,Schoolchild or full-time student indicator: Student,10920324,587567,11507891
TS068,68003,Schoolchild or full-time student indicator: Not a student,42492614,2364785,44857399
TS070,70001,Gender identity: Total: All usual residents aged 16 years and over,46006986,2559416,48566402
TS070,70002,Gender identity: Gender identity the same as sex registered at birth,43002331,2387303,45389634
TS070,70003,Gender identity: Gender identity different from sex registered at birth but no specific identity given,113757,4014,117771
TS070,70004,Gender identity: Trans woman,45696,1885,47581
TS070,70005,Gender identity: Trans man,46536,1920,48456
TS070,70006,Gender identity: Non-binary,28700,1553,30253
TS070,70007,Gender identity: All other gender identities,17178,899,18077
TS070,70008,Gender identity: Not answered,2752788,161842,2914630
TS071,71001,Total: All usual residents,46007014,2559398,48566412
TS071,71002,Previously served in UK armed forces,1325326,87932,1413258
TS071,71003,Previously served in UK reserve armed forces,338534,22253,360787
TS071,71004,Previously served in both regular and reserve UK armed forces,73921,5133,79054
TS071,71005,Has not previously served in any UK armed forces,44269233,2444080,46713313
TS072,72001,Total: All households,23436054,1347103,24783157
TS072,72002,No people in the household previously served in UK armed forces,21799724,1238414,23038138
TS072,72003,1 person in the household previously served in UK armed forces,1571356,104263,1675619
TS072,72004,2 people in the household previously served in UK armed,63328,4304,67632
TS072,72005,3 or more people in the household previously served in UK armed forces,1646,122,1768
TS073,73001,Total,1737728,115342,1853070
TS073,73002,Lives in a household,1702974,113266,1816240
TS073,73003,Lives in a communal establishment,34754,2076,36830
TS074,74001,Total: All households,23431903,1346602,24778505
TS074,74002,Household reference person previously served in regular UK armed forces,999272,65359,1064631
TS074,74003,Household reference person previously served in reserve UK armed forces,231106,15466,246572
TS074,74004,Household reference person previously served in both regular and reserve UK armed forces,58351,4057,62408
TS074,74005,Household reference person has not previously served in regular or reserve UK armed forces,22143174,1261720,23404894
TS075,75001,Multi religion household: Total,23436175,1347158,24783333
TS075,75002,Multi religion household: One-person household,7052433,429556,7481989
TS075,75003,Multi religion household: Multi-person household: No people stated their religion,435257,24764,460021
TS075,75004,Multi religion household: Multi-person household: Same religion (at least one person has stated a religion but the household may include people who did not state their religion),7756018,355740,8111758
TS075,75005,Multi religion household: Multi-person household: No religion (household may include people who did not state their religion),4710345,343693,5054038
TS075,75006,Multi religion household: Multi-person household: Same religion and no religion (household may include people who did not state their religion),3204978,185444,3390422
TS075,75007,Multi religion household: Multi-person household: At least two different religions stated (household may include people with no religion and who did not state their religion),277144,7961,285105
TS077,77001,Sexual orientation: Total: All usual residents aged 16 years and over,46007030,2559400,48566430
TS077,77002,Sexual orientation: Straight or Heterosexual,41114429,2288624,43403053
TS077,77003,Sexual orientation: Gay or Lesbian,709692,38102,747794
TS077,77004,Sexual orientation: Bisexual,591822,31815,623637
TS077,77005,Sexual orientation: All other sexual orientations,158355,6928,165283
TS077,77006,Sexual orientation: Not answered,3432732,193931,3626663
TS078,78001,Gender identity: Total: All usual residents aged 16 years and over,46006797,2559422,48566219
TS078,78002,Gender identity: Gender identity the same as sex registered at birth,43002330,2387316,45389646
TS078,78003,Gender identity: Gender identity different from sex registered at birth but no specific identity given,113730,4021,117751
TS078,78004,Gender identity: Trans woman,45635,1889,47524
TS078,78005,Gender identity: Trans man,46495,1916,48411
TS078,78006,Gender identity: All other gender identities,45895,2435,48330
TS078,78007,Gender identity: Not answered,2752712,161845,2914557
TS079,79001,Sexual orientation: Total: All usual residents aged 16 years and over,46006949,2559418,48566367
TS079,79002,Sexual orientation: Straight or Heterosexual,41114489,2288631,43403120
TS079,79003,Sexual orientation: Gay or Lesbian,709700,38101,747801
TS079,79004,Sexual orientation: Bisexual,591675,31814,623489
TS079,79005,Sexual orientation: Pansexual,107849,4535,112384
TS079,79006,Sexual orientation: Asexual,26612,1556,28168
TS079,79007,Sexual orientation: Queer,13927,585,14512
TS079,79008,Sexual orientation: All other sexual orientations,9955,273,10228
TS079,79009,Sexual orientation: Not answered,3432742,193923,3626665
